state_name,county_fips,county_name,votes_gop,votes_dem,total_votes,diff,per_gop,per_dem,per_point_diff
Alabama,01001,Autauga County,19838,7503,27770,12335,0.714368023046453,0.27018365142239825,0.4441843716240547
Alabama,01003,Baldwin County,83544,24578,109679,58966,0.7617137282433283,0.22409029987509005,0.5376234283682382
Alabama,01005,Barbour County,5622,4816,10518,806,0.5345122646891044,0.45788172656398557,0.07663053812511883
Alabama,01007,Bibb County,7525,1986,9595,5539,0.7842626367899947,0.20698280354351226,0.5772798332464825
Alabama,01009,Blount County,24711,2640,27588,22071,0.8957155284906481,0.09569377990430622,0.8000217485863419
Alabama,01011,Bullock County,1146,3446,4613,-2300,0.24842835464990246,0.7470192933015392,-0.49859093865163673
Alabama,01013,Butler County,5458,3965,9488,1493,0.5752529510961214,0.4178962900505902,0.1573566610455312
Alabama,01015,Calhoun County,35101,15216,50983,19885,0.6884843967597042,0.29845242531824334,0.39003197144146085
Alabama,01017,Chambers County,8753,6365,15284,2388,0.5726903951845067,0.41644857367181365,0.15624182151269306
Alabama,01019,Cherokee County,10583,1624,12301,8959,0.8603365580034144,0.13202178684659785,0.7283147711568165
Alabama,01021,Chilton County,16085,3073,19310,13012,0.8329880890730191,0.1591403417918177,0.6738477472812014
Alabama,01023,Choctaw County,4296,3127,7464,1169,0.5755627009646302,0.41894426580921756,0.15661843515541268
Alabama,01025,Clarke County,7324,5755,13135,1569,0.5575942139322421,0.4381423677198325,0.11945184621240956
Alabama,01027,Clay County,5601,1267,6930,4334,0.8082251082251082,0.18282828282828284,0.6253968253968254
Alabama,01029,Cleburne County,6484,675,7227,5809,0.8971910889719109,0.09339975093399751,0.8037913380379134
Alabama,01031,Coffee County,16899,5076,22275,11823,0.7586531986531987,0.22787878787878788,0.5307744107744108
Alabama,01033,Colbert County,19203,8343,27886,10860,0.688625116545937,0.2991823854263788,0.38944273111955824
Alabama,01035,Conecuh County,3442,2966,6441,476,0.5343890700201832,0.46048750194069243,0.07390156807949078
Alabama,01037,Coosa County,3631,1796,5479,1835,0.6627121737543348,0.3277970432560686,0.33491513049826616
Alabama,01039,Covington County,14586,2721,17430,11865,0.8368330464716007,0.15611015490533564,0.6807228915662651
Alabama,01041,Crenshaw County,4864,1700,6617,3164,0.7350763185733716,0.2569140093698051,0.47816230920356656
Alabama,01043,Cullman County,36880,4478,41851,32402,0.8812214761893383,0.10699863802537574,0.7742228381639626
Alabama,01045,Dale County,14303,5170,19738,9133,0.724642820954504,0.2619313000303982,0.46271152092410583
Alabama,01047,Dallas County,5524,12230,17864,-6706,0.30922525750111957,0.6846171070309002,-0.3753918495297806
Alabama,01049,DeKalb County,24767,4281,29356,20486,0.8436776127537812,0.14583049461779535,0.6978471181359858
Alabama,01051,Elmore County,30164,10367,41030,19797,0.7351693882524982,0.2526687789422374,0.48250060931026084
Alabama,01053,Escambia County,10869,4918,15910,5951,0.6831552482715273,0.3091137649277184,0.3740414833438089
Alabama,01055,Etowah County,35528,11567,47728,23961,0.7443848474689909,0.2423524974857526,0.5020323499832383
Alabama,01057,Fayette County,7300,1395,8766,5905,0.8327629477526808,0.1591375770020534,0.6736253707506275
Alabama,01059,Franklin County,10376,2086,12578,8290,0.8249324216886628,0.16584512641119414,0.6590872952774687
Alabama,01061,Geneva County,10848,1595,12545,9253,0.8647269828616979,0.12714228776404943,0.7375846950976485
Alabama,01063,Greene County,875,3884,4775,-3009,0.18324607329842932,0.8134031413612566,-0.6301570680628272
Alabama,01065,Hale County,3190,4687,7922,-1497,0.40267609189598585,0.5916435243625348,-0.1889674324665489
Alabama,01067,Henry County,6607,2606,9298,4001,0.7105829210582921,0.2802753280275328,0.43030759303075933
Alabama,01069,Houston County,32618,12917,46173,19701,0.7064301648149351,0.27975223615532885,0.4266779286596063
Alabama,01071,Jackson County,19670,3717,23636,15953,0.8322051108478592,0.15726011169402607,0.6749449991538331
Alabama,01073,Jefferson County,138843,181688,325848,-42845,0.426097444207115,0.5575851317178562,-0.1314876875107412
Alabama,01075,Lamar County,6174,978,7193,5196,0.858334491867093,0.13596552203531212,0.7223689698317809
Alabama,01077,Lauderdale County,31721,11915,44339,19806,0.7154198335551095,0.26872505018155574,0.4466947833735538
Alabama,01079,Lawrence County,12322,3562,16031,8760,0.7686357681991142,0.22219449815981535,0.5464412700392989
Alabama,01081,Lee County,42221,27860,71449,14361,0.590924995451301,0.38992848045459,0.20099651499671095
Alabama,01083,Limestone County,34640,13672,49235,20968,0.7035645374225652,0.27768863613283234,0.42587590128973285
Alabama,01085,Lowndes County,1836,4972,6835,-3136,0.2686174103877103,0.7274323335771763,-0.458814923189466
Alabama,01087,Macon County,1541,7108,8723,-5567,0.1766594061676029,0.8148572738736674,-0.6381978677060645
Alabama,01089,Madison County,102780,87286,194767,15494,0.5277074658438031,0.4481560017867503,0.07955146405705282
Alabama,01091,Marengo County,5343,5488,10900,-145,0.4901834862385321,0.50348623853211,-0.013302752293577969
Alabama,01093,Marion County,12205,1463,13807,10742,0.8839718983124502,0.10596074454986601,0.7780111537625841
Alabama,01095,Marshall County,33191,5943,39655,27248,0.8369940738872778,0.1498676081200353,0.6871264657672425
Alabama,01097,Mobile County,101243,79474,183164,21769,0.5527450809110961,0.43389530693804457,0.11884977397305152
Alabama,01099,Monroe County,6147,4455,10668,1692,0.5762092238470191,0.4176040494938133,0.1586051743532058
Alabama,01101,Montgomery County,33311,64529,99139,-31218,0.3360029857069367,0.6508941990538537,-0.314891213346917
Alabama,01103,Morgan County,39664,13234,53722,26430,0.7383194966680318,0.24634228062990954,0.4919772160381222
Alabama,01105,Perry County,1339,3860,5230,-2521,0.2560229445506692,0.7380497131931166,-0.4820267686424474
Alabama,01107,Pickens County,5594,4022,9668,1572,0.5786098469176665,0.41601158460901944,0.16259826230864705
Alabama,01109,Pike County,8042,5636,13841,2406,0.5810273824145654,0.40719601184885484,0.17383137056571057
Alabama,01111,Randolph County,8559,2203,10837,6356,0.7897942234935867,0.20328504198578942,0.5865091815077973
Alabama,01113,Russell County,9864,11228,21329,-1364,0.46246893900323505,0.5264194289465047,-0.06395048994326968
Alabama,01115,St. Clair County,36166,7744,44441,28422,0.8137980693503747,0.1742535046466101,0.6395445647037645
Alabama,01117,Shelby County,79700,33268,114950,46432,0.6933449325793823,0.28941278816876903,0.4039321444106133
Alabama,01119,Sumter County,1598,4648,6291,-3050,0.2540136703226832,0.7388332538547131,-0.4848195835320299
Alabama,01121,Talladega County,22235,13138,35663,9097,0.623475310545944,0.3683930123657572,0.25508229818018674
Alabama,01123,Tallapoosa County,14963,5859,20991,9104,0.7128293077985803,0.2791196226954409,0.43370968510313945
Alabama,01125,Tuscaloosa County,51117,37765,90172,13352,0.566883289712993,0.41881071729583463,0.14807257241715832
Alabama,01127,Walker County,26002,4834,31170,21168,0.8341995508501765,0.15508501764517163,0.6791145332050048
Alabama,01129,Washington County,6564,2258,8876,4306,0.7395223073456512,0.254393871113114,0.48512843623253715
Alabama,01131,Wilcox County,1833,4048,5903,-2215,0.3105200745383703,0.6857530069456209,-0.3752329324072506
Alabama,01133,Winston County,10195,974,11284,9221,0.9034916696207019,0.08631690889755406,0.8171747607231479
Alaska,02901,District 1,3511,3477,7360,34,0.47703804347826084,0.4724184782608696,0.004619565217391264
Alaska,02902,District 2,3674,2104,6161,1570,0.5963317643239734,0.3415030027592923,0.2548287615646811
Alaska,02903,District 3,6076,1903,8385,4173,0.7246273106738224,0.22695289206917113,0.4976744186046512
Alaska,02904,District 4,4690,5345,10587,-655,0.4429961273259658,0.5048644564088033,-0.06186832908283746
Alaska,02905,District 5,4077,4204,8706,-127,0.4682977257064094,0.4828853664139674,-0.014587640707558025
Alaska,02906,District 6,5770,3272,9518,2498,0.6062197940743854,0.34376969951670516,0.26245009455768026
Alaska,02907,District 7,7027,2215,9664,4812,0.7271316225165563,0.22920115894039736,0.4979304635761589
Alaska,02908,District 8,7618,1953,9957,5665,0.7650898865120016,0.19614341669177462,0.568946469820227
Alaska,02909,District 9,7787,2769,11047,5018,0.7048972571738934,0.25065628677469,0.4542409703992034
Alaska,02910,District 10,8081,2727,11256,5354,0.7179282160625444,0.24227078891257997,0.47565742714996445
Alaska,02911,District 11,7096,3130,10686,3966,0.6640464158712334,0.2929066067752199,0.37113980909601346
Alaska,02912,District 12,7893,2957,11280,4936,0.6997340425531915,0.26214539007092197,0.4375886524822695
Alaska,02913,District 13,4652,2666,7765,1986,0.5990985189954926,0.3433354797166774,0.2557630392788152
Alaska,02914,District 14,6714,4261,11534,2453,0.5821050806311774,0.369429512744928,0.21267556788624936
Alaska,02915,District 15,2671,2622,5593,49,0.4775612372608618,0.46880028607187557,0.008760951188986232
Alaska,02916,District 16,3516,4274,8170,-758,0.4303549571603427,0.5231334149326805,-0.09277845777233779
Alaska,02917,District 17,2810,4136,7271,-1326,0.3864667858616421,0.5688350983358548,-0.18236831247421265
Alaska,02918,District 18,2760,4681,7759,-1921,0.35571594277613094,0.6032993942518365,-0.2475834514757056
Alaska,02919,District 19,1975,3118,5338,-1143,0.36998875983514423,0.5841139003372049,-0.21412514050206066
Alaska,02920,District 20,2383,4881,7544,-2498,0.3158801696712619,0.6470042417815483,-0.3311240721102863
Alaska,02921,District 21,3690,5414,9482,-1724,0.3891584053997047,0.5709765872178865,-0.18181818181818177
Alaska,02922,District 22,4684,4553,9597,131,0.48806918828800666,0.4744190892987392,0.013650098989267445
Alaska,02923,District 23,3655,3810,7796,-155,0.46883016931759874,0.4887121600820934,-0.01988199076449465
Alaska,02924,District 24,5378,4736,10484,642,0.5129721480351012,0.45173597863410914,0.061236169400992024
Alaska,02925,District 25,4407,4600,9369,-193,0.47038104386807555,0.4909808944391077,-0.02059985057103214
Alaska,02926,District 26,5243,4558,20292,685,0.2583776857875025,0.22462054011433077,0.0337571456731717
Alaska,02927,District 27,4324,4844,19037,-520,0.2271366286704838,0.2544518569102274,-0.02731522823974364
Alaska,02928,District 28,6162,6264,25580,-102,0.24089132134480062,0.24487881157154026,-0.003987490226739637
Alaska,02929,District 29,7464,2985,10784,4479,0.6921364985163204,0.27679896142433236,0.41533753709198806
Alaska,02930,District 30,7180,2638,10226,4542,0.7021318208488168,0.2579698806962644,0.44416194015255234
Alaska,02931,District 31,6971,5037,12481,1934,0.5585289640253185,0.4035734316160564,0.15495553240926208
Alaska,02932,District 32,4440,3506,8361,934,0.5310369573017582,0.41932783159909104,0.11170912570266711
Alaska,02933,District 33,3059,7535,11016,-4476,0.27768700072621644,0.6840050835148874,-0.406318082788671
Alaska,02934,District 34,4543,5763,10794,-1220,0.42088197146562906,0.5339077265147304,-0.11302575504910134
Alaska,02935,District 35,4769,5011,10149,-242,0.46989851216868656,0.4937432259335895,-0.023844713764902936
Alaska,02936,District 36,5114,3796,9292,1318,0.550365906155833,0.40852346104175635,0.14184244511407668
Alaska,02937,District 37,2358,2560,5168,-202,0.45626934984520123,0.4953560371517028,-0.039086687306501555
Alaska,02938,District 38,1737,3202,5299,-1465,0.32779769767880734,0.6042649556520098,-0.27646725797320243
Alaska,02939,District 39,1939,3580,5930,-1641,0.3269814502529511,0.6037099494097807,-0.2767284991568296
Alaska,02940,District 40,1994,2318,4628,-324,0.4308556611927398,0.5008643042350908,-0.07000864304235094
Arizona,04001,Apache County,11442,23293,35183,-11851,0.32521388170423216,0.662052695904272,-0.3368388142000398
Arizona,04003,Cochise County,35557,23732,60473,11825,0.5879814131926645,0.3924396011443123,0.1955418120483522
Arizona,04005,Coconino County,27052,44698,73346,-17646,0.36882720257410084,0.6094129195866168,-0.24058571701251596
Arizona,04007,Gila County,18377,8943,27678,9434,0.6639569333044295,0.32310860611315845,0.34084832719127106
Arizona,04009,Graham County,10749,4034,14996,6715,0.716791144305148,0.26900506801813817,0.44778607628700984
Arizona,04011,Greenlee County,2433,1182,3688,1251,0.65970715835141,0.32049891540130154,0.3392082429501085
Arizona,04012,La Paz County,5129,2236,7460,2893,0.6875335120643432,0.2997319034852547,0.3878016085790885
Arizona,04013,Maricopa County,995665,1040774,2069475,-45109,0.4811196076299545,0.5029169233742857,-0.021797315744331247
Arizona,04015,Mohave County,78535,24831,104705,53704,0.7500596915142543,0.23715199847189725,0.5129076930423571
Arizona,04017,Navajo County,27657,23383,51783,4274,0.5340942007994902,0.45155746094278043,0.08253673985670978
Arizona,04019,Pima County,207758,304981,520735,-97223,0.39897068566545363,0.5856740952691868,-0.18670340960373316
Arizona,04021,Pinal County,107077,75106,185037,31971,0.57867885882283,0.40589719893859066,0.17278165988423932
Arizona,04023,Santa Cruz County,6194,13138,19561,-6944,0.3166504779919227,0.6716425540616533,-0.3549920760697306
Arizona,04025,Yavapai County,91527,49602,143280,41925,0.6387981574539363,0.3461892797319933,0.292608877721943
Arizona,04027,Yuma County,36534,32210,69926,4324,0.5224666075565598,0.4606298086548637,0.06183679890169613
Arkansas,05001,Arkansas County,4304,1818,6292,2486,0.684043229497775,0.28893833439287986,0.3951048951048951
Arkansas,05003,Ashley County,5548,2125,7926,3423,0.6999747665909665,0.2681049709815796,0.4318697956093869
Arkansas,05005,Baxter County,15836,4635,21007,11201,0.7538439567763127,0.22064073880135193,0.5332032179749607
Arkansas,05007,Benton County,73965,42249,119912,31716,0.6168273400493696,0.3523333778103943,0.26449396223897526
Arkansas,05009,Boone County,13652,3064,17114,10588,0.7977094776206615,0.17903470842585018,0.6186747691948113
Arkansas,05011,Bradley County,2335,1214,3654,1121,0.6390257252326218,0.3322386425834702,0.3067870826491516
Arkansas,05013,Calhoun County,1636,479,2182,1157,0.7497708524289642,0.21952337305224565,0.5302474793767186
Arkansas,05015,Carroll County,7424,4023,11797,3401,0.6293125370856998,0.3410189031109604,0.2882936339747394
Arkansas,05017,Chicot County,1752,2260,4103,-508,0.42700463075798195,0.5508164757494516,-0.12381184499146963
Arkansas,05019,Clark County,4616,3438,8395,1178,0.5498511018463371,0.4095294818344253,0.14032162001191184
Arkansas,05021,Clay County,4086,962,5183,3124,0.78834651746093,0.1856067914335327,0.6027397260273972
Arkansas,05023,Cleburne County,10328,1988,12680,8340,0.8145110410094637,0.15678233438485806,0.6577287066246056
Arkansas,05025,Cleveland County,2867,651,3600,2216,0.7963888888888889,0.18083333333333335,0.6155555555555556
Arkansas,05027,Columbia County,5500,2814,8616,2686,0.638347260909935,0.3266016713091922,0.3117455896007428
Arkansas,05029,Conway County,5694,2615,8685,3079,0.6556131260794473,0.30109383995394357,0.35451928612550376
Arkansas,05031,Craighead County,25558,11921,38511,13637,0.6636545402612241,0.30954792137311415,0.3541066188881099
Arkansas,05033,Crawford County,18607,4959,24091,13648,0.7723631231580258,0.20584450624714623,0.5665186169108796
Arkansas,05035,Crittenden County,7333,8514,16367,-1181,0.44803568155434714,0.5201930714242072,-0.07215738986986009
Arkansas,05037,Cross County,4946,1772,6942,3174,0.7124747911264765,0.25525785076346874,0.45721694036300775
Arkansas,05039,Dallas County,1573,963,2649,610,0.5938089845224613,0.3635334088335221,0.23027557568893925
Arkansas,05041,Desha County,1921,2016,4164,-95,0.4613352545629203,0.484149855907781,-0.022814601344860685
Arkansas,05043,Drew County,4349,2426,6908,1923,0.6295599305153445,0.3511870295309786,0.27837290098436596
Arkansas,05045,Faulkner County,34421,18347,54428,16074,0.6324134636584111,0.3370875284779893,0.29532593518042183
Arkansas,05047,Franklin County,5677,1300,7129,4377,0.7963248702482817,0.18235376630663488,0.6139711039416468
Arkansas,05049,Fulton County,3961,1035,5119,2926,0.7737839421762063,0.20218792732955657,0.5715960148466497
Arkansas,05051,Garland County,29069,14045,44199,15024,0.6576845629991629,0.3177673703024955,0.33991719269666737
Arkansas,05053,Grant County,6794,1268,8200,5526,0.8285365853658536,0.1546341463414634,0.6739024390243902
Arkansas,05055,Greene County,12670,3058,16100,9612,0.7869565217391304,0.18993788819875776,0.5970186335403727
Arkansas,05057,Hempstead County,4470,2138,6848,2332,0.6527453271028038,0.31220794392523366,0.3405373831775701
Arkansas,05059,Hot Spring County,9202,3082,12557,6120,0.7328183483316079,0.2454407899976109,0.487377558333997
Arkansas,05061,Howard County,3367,1340,4834,2027,0.6965246172941664,0.2772031443938767,0.41932147290028965
Arkansas,05063,Independence County,11250,2806,14512,8444,0.7752205071664829,0.1933572216097023,0.5818632855567807
Arkansas,05065,Izard County,4631,1021,5810,3610,0.7970740103270224,0.1757314974182444,0.621342512908778
Arkansas,05067,Jackson County,3593,1365,5091,2228,0.7057552543704577,0.26812021213906895,0.43763504223138877
Arkansas,05069,Jefferson County,9521,14981,25158,-5460,0.37844820732967643,0.5954765879640671,-0.21702838063439067
Arkansas,05071,Johnson County,6938,2283,9498,4655,0.7304695725415877,0.24036639292482628,0.4901031796167614
Arkansas,05073,Lafayette County,1757,839,2679,918,0.6558417319895483,0.3131765584173199,0.3426651735722284
Arkansas,05075,Lawrence County,4569,1080,5857,3489,0.7800921973706676,0.18439474133515452,0.595697456035513
Arkansas,05077,Lee County,1286,1423,2848,-137,0.4515449438202247,0.4996488764044944,-0.048103932584269704
Arkansas,05079,Lincoln County,2729,1032,3875,1697,0.704258064516129,0.2663225806451613,0.43793548387096776
Arkansas,05081,Little River County,3715,1226,5177,2489,0.7175970639366428,0.2368166892022407,0.4807803747344021
Arkansas,05083,Logan County,6441,1544,8225,4897,0.7831003039513678,0.18772036474164133,0.5953799392097264
Arkansas,05085,Lonoke County,22884,6686,30662,16198,0.7463309634074751,0.21805492140108276,0.5282760420063923
Arkansas,05087,Madison County,5658,1563,7351,4095,0.7696911984763978,0.21262413277105155,0.5570670657053463
Arkansas,05089,Marion County,5783,1531,7503,4252,0.7707583633213382,0.20405171264827401,0.5667066506730641
Arkansas,05091,Miller County,11920,4245,16529,7675,0.7211567547946034,0.25682134430395065,0.46433541049065274
Arkansas,05093,Mississippi County,7296,4558,12342,2738,0.5911521633446767,0.3693080538000324,0.22184410954464429
Arkansas,05095,Monroe County,1545,1147,2816,398,0.5486505681818182,0.4073153409090909,0.14133522727272735
Arkansas,05097,Montgomery County,3046,731,3873,2315,0.7864704363542474,0.1887425768138394,0.597727859540408
Arkansas,05099,Nevada County,2133,1076,3358,1057,0.6351995235259082,0.32042882668254913,0.3147706968433591
Arkansas,05101,Newton County,3192,709,3998,2483,0.7983991995997999,0.17733866933466733,0.6210605302651325
Arkansas,05103,Ouachita County,5294,3995,9629,1299,0.5497974867587496,0.41489251220272094,0.13490497455602868
Arkansas,05105,Perry County,3479,1012,4627,2467,0.7518910741301059,0.21871623081910524,0.5331748433110006
Arkansas,05107,Phillips County,2417,3623,6242,-1206,0.38721563601409803,0.5804229413649471,-0.19320730535084907
Arkansas,05109,Pike County,3519,644,4246,2875,0.8287800282618936,0.15167216203485634,0.6771078662270372
Arkansas,05111,Poinsett County,5918,1424,7521,4494,0.7868634490094403,0.18933652439835127,0.597526924611089
Arkansas,05113,Polk County,7035,1246,8490,5789,0.8286219081272085,0.14676089517078916,0.6818610129564193
Arkansas,05115,Pope County,18081,5772,24432,12309,0.7400540275049116,0.2362475442043222,0.5038064833005893
Arkansas,05117,Prairie County,2786,654,3495,2132,0.7971387696709585,0.1871244635193133,0.6100143061516452
Arkansas,05119,Pulaski County,63687,101947,169956,-38260,0.3747263997740592,0.5998434889030102,-0.225117089128951
Arkansas,05121,Randolph County,5355,1215,6812,4140,0.7861127422196125,0.1783617146212566,0.6077510275983559
Arkansas,05123,St. Francis County,3242,3604,7108,-362,0.45610579628587505,0.5070343275182893,-0.0509285312324142
Arkansas,05125,Saline County,39556,16060,56959,23496,0.6944644393335557,0.28195719728225566,0.41250724205130007
Arkansas,05127,Scott County,2962,483,3551,2479,0.8341312306392565,0.13601802309208674,0.6981132075471698
Arkansas,05129,Searcy County,3365,588,4019,2777,0.8372729534710127,0.14630505100771335,0.6909679024632993
Arkansas,05131,Sebastian County,31198,14487,47140,16711,0.6618158676283411,0.3073186253712346,0.3544972422571065
Arkansas,05133,Sevier County,3884,1116,5202,2768,0.746635909265667,0.21453287197231835,0.5321030372933486
Arkansas,05135,Sharp County,5938,1398,7566,4540,0.7848268569918054,0.18477398889770025,0.6000528680941052
Arkansas,05137,Stone County,4616,1180,5938,3436,0.7773661165375547,0.19872010778039745,0.5786460087571572
Arkansas,05139,Union County,10478,5584,16607,4894,0.6309387607635335,0.33624375263443124,0.29469500812910226
Arkansas,05141,Van Buren County,6034,1593,7807,4441,0.7728961188676828,0.20404764954527987,0.568848469322403
Arkansas,05143,Washington County,47504,43824,94266,3680,0.5039356713979589,0.46489720577939025,0.03903846561856866
Arkansas,05145,White County,24182,5978,30885,18204,0.7829690788408613,0.19355674275538287,0.5894123360854784
Arkansas,05147,Woodruff County,1543,856,2476,687,0.6231825525040388,0.345718901453958,0.27746365105008075
Arkansas,05149,Yell County,5226,1284,6741,3942,0.7752558967512239,0.19047619047619047,0.5847797062750334
California,06001,Alameda County,136309,617659,769864,-481350,0.1770559475439818,0.8022962497272246,-0.6252403021832428
California,06003,Alpine County,244,476,741,-232,0.3292847503373819,0.6423751686909581,-0.3130904183535762
California,06005,Amador County,13585,8153,22302,5432,0.6091381938839566,0.3655725943861537,0.24356559949780293
California,06007,Butte County,48730,50426,102042,-1696,0.4775484604378589,0.4941690676388154,-0.016620607200956483
California,06009,Calaveras County,16518,10046,27164,6472,0.6080842291267855,0.36982771314975704,0.23825651597702846
California,06011,Colusa County,4554,3234,7951,1320,0.5727581436297321,0.4067412904037228,0.1660168532260093
California,06013,Contra Costa County,152877,416386,581230,-263509,0.2630232438105397,0.716387660650689,-0.45336441684014933
California,06015,Del Norte County,6461,4677,11452,1784,0.5641809290953546,0.4084002794271743,0.15578064966818028
California,06017,El Dorado County,61838,51621,116138,10217,0.5324527717026296,0.44447984294546145,0.08797292875716817
California,06019,Fresno County,164464,193025,364809,-28561,0.45082221107483644,0.5291124944834146,-0.07829028340857813
California,06021,Glenn County,7063,3995,11292,3068,0.625487070492384,0.35379029401346085,0.2716967764789231
California,06023,Humboldt County,21770,44768,68828,-22998,0.3162956936130645,0.6504329633288778,-0.3341372697158133
California,06025,Imperial County,20847,34678,56718,-13831,0.3675552734581614,0.6114108395923693,-0.2438555661342079
California,06027,Inyo County,4620,4634,9481,-14,0.4872903702141124,0.48876700769960973,-0.0014766374854973119
California,06029,Kern County,164484,133366,305226,31118,0.5388924927758448,0.4369418070544449,0.10195068572139993
California,06031,Kings County,24072,18699,43858,5373,0.5488622372201195,0.42635323088148114,0.12250900633863837
California,06033,Lake County,13123,14941,28800,-1818,0.45565972222222223,0.5187847222222223,-0.06312500000000004
California,06035,Lassen County,8970,2799,11985,6171,0.7484355444305382,0.23354192740926158,0.5148936170212766
California,06037,Los Angeles County,1145530,3028885,4263443,-1883355,0.2686865990702819,0.7104316863154967,-0.4417450872452148
California,06039,Madera County,29378,23168,53722,6210,0.5468523137634489,0.4312572130598265,0.11559510070362239
California,06041,Marin County,24612,128288,155801,-103676,0.15797074473206205,0.8234093491055898,-0.6654386043735278
California,06043,Mariposa County,5950,4088,10280,1862,0.5787937743190662,0.3976653696498054,0.18112840466926078
California,06045,Mendocino County,13267,28782,43336,-15515,0.30614269891083623,0.664159128669005,-0.3580164297581687
California,06047,Merced County,39397,48991,90541,-9594,0.43512883665963487,0.5410918810262754,-0.1059630443666405
California,06049,Modoc County,3109,1150,4338,1959,0.7166897187644076,0.26509912402028585,0.4515905947441217
California,06051,Mono County,2513,4013,6737,-1500,0.3730146949680867,0.5956657265845332,-0.2226510316164465
California,06053,Monterey County,46299,113953,163883,-67654,0.2825125241788349,0.6953314254681694,-0.4128189012893345
California,06055,Napa County,20676,49817,72122,-29141,0.2866809018052744,0.6907323701505782,-0.4040514683453038
California,06057,Nevada County,26779,36359,64738,-9580,0.4136519509407149,0.5616330439618153,-0.14798109302110046
California,06059,Orange County,676498,814009,1521725,-137511,0.4445599566281687,0.5349251671622665,-0.09036521053409774
California,06061,Placer County,122488,106869,235017,15619,0.5211878289655641,0.45472880685227024,0.06645902211329391
California,06063,Plumas County,6445,4561,11256,1884,0.5725835110163469,0.40520611229566456,0.1673773987206823
California,06065,Riverside County,448702,527945,996156,-79243,0.45043346624424285,0.5299822517758263,-0.0795487855315834
California,06067,Sacramento County,259405,440808,718290,-181403,0.3611424355065503,0.6136908490999458,-0.25254841359339547
California,06069,San Benito County,10590,17628,28821,-7038,0.36744040803580724,0.6116373477672531,-0.24419693973144585
California,06071,San Bernardino County,366257,455859,840931,-89602,0.4355375173468453,0.5420884709922693,-0.106550953645424
California,06073,San Diego County,600094,964650,1601722,-364556,0.374655526989078,0.6022580697524289,-0.2276025427633509
California,06075,San Francisco County,56417,378156,443458,-321739,0.1272206161575617,0.8527436645634987,-0.725523048405937
California,06077,San Joaquin County,121098,161137,288443,-40039,0.419833381291971,0.5586441688652524,-0.13881078757328136
California,06079,San Luis Obispo County,67436,88310,159681,-20874,0.4223169945077999,0.5530401237467201,-0.13072312923892015
California,06081,San Mateo County,75563,291410,374138,-215847,0.20196558489113642,0.7788837273947046,-0.5769181425035681
California,06083,Santa Barbara County,65736,129963,200288,-64227,0.328207381370826,0.6488806119188368,-0.32067323054801083
California,06085,Santa Clara County,214612,617967,850522,-403355,0.2523297457326207,0.7265737982086296,-0.47424405247600887
California,06087,Santa Cruz County,26937,114246,144796,-87309,0.18603414458962955,0.7890135086604603,-0.6029793640708307
California,06089,Shasta County,60789,30000,92900,30789,0.6543487621097955,0.32292787944025836,0.3314208826695372
California,06091,Sierra County,1142,730,1930,412,0.5917098445595855,0.37823834196891193,0.2134715025906736
California,06093,Siskiyou County,13290,9593,23450,3697,0.5667377398720682,0.40908315565031983,0.15765458422174838
California,06095,Solano County,69306,131639,205831,-62333,0.3367131287318237,0.6395489503524736,-0.3028358216206499
California,06097,Sonoma County,61825,199938,268252,-138113,0.23047358453991024,0.7453364746581572,-0.514862890118247
California,06099,Stanislaus County,104145,105841,214876,-1696,0.4846748822576742,0.4925678065488933,-0.007892924291219128
California,06101,Sutter County,24375,17367,42640,7008,0.5716463414634146,0.4072936210131332,0.16435272045028143
California,06103,Tehama County,19141,8911,28721,10230,0.6664461543818112,0.3102607847916159,0.3561853695901953
California,06105,Trinity County,3188,2851,6258,337,0.5094279322467242,0.45557686161713007,0.053851070629594155
California,06107,Tulare County,77579,66105,146832,11474,0.5283521303258145,0.45020840143837854,0.07814372888743598
California,06109,Tuolumne County,17689,11978,30401,5711,0.5818558600046051,0.39400019736192887,0.18785566264267622
California,06111,Ventura County,162207,251388,422698,-89181,0.3837420569768487,0.5947224732551373,-0.21098041627828856
California,06113,Yolo County,27292,67598,97264,-40306,0.2805971376871196,0.6949950649777924,-0.4143979272906728
California,06115,Yuba County,17676,11230,29787,6446,0.593413233961124,0.37701010507939703,0.21640312888172697
Colorado,08001,Adams County,95657,134202,236735,-38545,0.40406783956744885,0.5668870255771221,-0.16281918600967327
Colorado,08003,Alamosa County,3813,3759,7808,54,0.4883452868852459,0.48142930327868855,0.006915983606557374
Colorado,08005,Arapahoe County,127323,213607,350183,-86284,0.36358989442662837,0.60998677834161,-0.2463968839149816
Colorado,08007,Archuleta County,5189,3738,9144,1451,0.5674759405074365,0.40879265091863515,0.1586832895888014
Colorado,08009,Baca County,1867,317,2225,1550,0.8391011235955056,0.14247191011235955,0.696629213483146
Colorado,08011,Bent County,1503,732,2274,771,0.6609498680738787,0.32189973614775724,0.33905013192612143
Colorado,08013,Boulder County,42501,159089,206111,-116588,0.20620442382987808,0.7718607934559534,-0.5656563696260752
Colorado,08014,Broomfield County,16295,29077,46632,-12782,0.3494381540572997,0.6235417738891749,-0.27410361983187514
Colorado,08015,Chaffee County,6222,7160,13717,-938,0.4535977254501713,0.521980024786761,-0.06838229933658968
Colorado,08017,Cheyenne County,993,131,1136,862,0.8741197183098591,0.1153169014084507,0.7588028169014084
Colorado,08019,Clear Creek County,2754,3604,6548,-850,0.4205864386072083,0.550397067806964,-0.12981062919975567
Colorado,08021,Conejos County,2286,1959,4333,327,0.5275790445418879,0.45211170090006925,0.07546734364181862
Colorado,08023,Costilla County,741,1311,2094,-570,0.3538681948424069,0.6260744985673352,-0.2722063037249283
Colorado,08025,Crowley County,1271,437,1750,834,0.7262857142857143,0.24971428571428572,0.4765714285714286
Colorado,08027,Custer County,2474,1112,3634,1362,0.6807925151348376,0.30599889928453494,0.3747936158503027
Colorado,08029,Delta County,13081,5887,19370,7194,0.6753226639132679,0.3039235931853381,0.37139907072792977
Colorado,08031,Denver County,71618,313293,393827,-241675,0.18185142207111243,0.7955091956620547,-0.6136577735909423
Colorado,08033,Dolores County,1089,341,1449,748,0.7515527950310559,0.23533471359558317,0.5162180814354727
Colorado,08035,Douglas County,121270,104653,231599,16617,0.5236205683098805,0.45187155384954164,0.07174901446033882
Colorado,08037,Eagle County,9892,18588,29140,-8696,0.3394646533973919,0.6378860672614962,-0.2984214138641043
Colorado,08039,Elbert County,14027,4490,18983,9537,0.7389243006900912,0.23652741926987306,0.5023968814202181
Colorado,08041,El Paso County,202828,161941,378849,40887,0.5353795311588522,0.42745526581830756,0.10792426534054461
Colorado,08043,Fremont County,17517,7369,25557,10148,0.6854090855734241,0.2883358766678405,0.39707320890558356
Colorado,08045,Garfield County,14717,15427,30904,-710,0.47621667098110276,0.4991910432306498,-0.022974372249547015
Colorado,08047,Gilpin County,1833,2223,4186,-390,0.43788819875776397,0.531055900621118,-0.09316770186335399
Colorado,08049,Grand County,4883,4710,9870,173,0.49473150962512663,0.47720364741641336,0.017527862208713274
Colorado,08051,Gunnison County,3735,7132,11190,-3397,0.33378016085790885,0.6373547810545129,-0.3035746201966041
Colorado,08053,Hinsdale County,353,255,632,98,0.5585443037974683,0.40348101265822783,0.1550632911392405
Colorado,08055,Huerfano County,2203,2076,4406,127,0.5,0.4711756695415343,0.02882433045846572
Colorado,08057,Jackson County,681,175,876,506,0.7773972602739726,0.1997716894977169,0.5776255707762556
Colorado,08059,Jefferson County,148417,218396,377357,-69979,0.39330660356108404,0.5787516860691599,-0.1854450825080759
Colorado,08061,Kiowa County,795,98,903,697,0.8803986710963455,0.10852713178294573,0.7718715393133998
Colorado,08063,Kit Carson County,3144,662,3871,2482,0.812193231723069,0.17101524153965383,0.6411779901834151
Colorado,08065,Lake County,1497,2303,3961,-806,0.3779348649330977,0.5814188336278717,-0.20348396869477403
Colorado,08067,La Plata County,14233,20548,35667,-6315,0.3990523453051841,0.5761067653573331,-0.177054420052149
Colorado,08069,Larimer County,91489,126120,224338,-34631,0.40781766798313257,0.5621874136347832,-0.15436974565165063
Colorado,08071,Las Animas County,4284,3497,7961,787,0.5381233513377717,0.4392664238161035,0.09885692752166819
Colorado,08073,Lincoln County,2135,470,2651,1665,0.8053564692568842,0.17729158807996984,0.6280648811769144
Colorado,08075,Logan County,8087,2218,10532,5869,0.7678503608051652,0.21059627800987465,0.5572540827952905
Colorado,08077,Mesa County,56894,31536,90622,25358,0.6278166449647988,0.34799496810928915,0.2798216768555097
Colorado,08079,Mineral County,427,317,756,110,0.5648148148148148,0.4193121693121693,0.14550264550264547
Colorado,08081,Moffat County,5670,1203,7026,4467,0.807002561912895,0.17122117847993168,0.6357813834329633
Colorado,08083,Montezuma County,9306,5836,15500,3470,0.6003870967741936,0.37651612903225806,0.2238709677419355
Colorado,08085,Montrose County,16770,7687,24922,9083,0.6728994462723698,0.3084423401011155,0.36445710617125426
Colorado,08087,Morgan County,9593,3876,13744,5717,0.697977299185099,0.2820139697322468,0.4159633294528522
Colorado,08089,Otero County,5756,3605,9576,2151,0.6010860484544696,0.37646198830409355,0.224624060150376
Colorado,08091,Ouray County,1577,2365,4020,-788,0.39228855721393036,0.5883084577114428,-0.19601990049751244
Colorado,08093,Park County,6991,4903,12290,2088,0.5688364524003254,0.3989422294548413,0.16989422294548412
Colorado,08095,Phillips County,1958,486,2485,1472,0.7879275653923541,0.19557344064386317,0.5923541247484909
Colorado,08097,Pitkin County,2780,8989,11957,-6209,0.2324997909174542,0.7517772016392071,-0.5192774107217529
Colorado,08099,Prowers County,4008,1458,5561,2550,0.7207336809926272,0.2621830606006114,0.45855062039201583
Colorado,08101,Pueblo County,42252,43772,88299,-1520,0.47851051540787554,0.49572475339471567,-0.01721423798684013
Colorado,08103,Rio Blanco County,3061,561,3691,2500,0.8293145489027364,0.1519913302628014,0.6773232186399349
Colorado,08105,Rio Grande County,3660,2495,6305,1165,0.5804916732751785,0.3957176843774782,0.1847739888977003
Colorado,08107,Routt County,5925,10582,16876,-4657,0.35109030575965866,0.62704432329936,-0.27595401753970134
Colorado,08109,Saguache County,1413,1884,3389,-471,0.4169371496016524,0.5559161994688698,-0.13897904986721743
Colorado,08111,San Juan County,202,342,563,-140,0.35879218472468916,0.6074600355239786,-0.2486678507992895
Colorado,08113,San Miguel County,1136,3924,5147,-2788,0.22071109384107246,0.7623858558383524,-0.5416747619972799
Colorado,08115,Sedgwick County,1121,301,1446,820,0.7752420470262794,0.20816044260027664,0.5670816044260027
Colorado,08117,Summit County,5322,12631,18479,-7309,0.2880025975431571,0.6835326586936522,-0.3955300611504951
Colorado,08119,Teller County,11241,5278,16939,5963,0.6636165062872661,0.3115886415963162,0.3520278646909499
Colorado,08121,Washington County,2595,369,3008,2226,0.8626994680851063,0.12267287234042554,0.7400265957446808
Colorado,08123,Weld County,96145,66060,166968,30085,0.5758289013463658,0.39564467442863305,0.18018422691773273
Colorado,08125,Yuma County,4107,785,4981,3322,0.8245332262597872,0.15759887572776551,0.6669343505320217
Connecticut,09001,Fairfield County,169039,297505,472990,-128466,0.3573838770375695,0.6289879278631684,-0.27160405082559885
Connecticut,09003,Hartford County,159024,283368,449336,-124344,0.3539088788790571,0.6306372069008492,-0.27672832802179215
Connecticut,09005,Litchfield County,55601,50164,107544,5437,0.5170069924867962,0.4664509410101912,0.05055605147660497
Connecticut,09007,Middlesex County,40665,56848,99203,-16183,0.40991703879922986,0.5730471860730019,-0.163130147273772
Connecticut,09009,New Haven County,169892,242629,417980,-72737,0.4064596392171874,0.5804799272692474,-0.17402028805205993
Connecticut,09011,New London County,57110,79459,139604,-22349,0.40908569955015617,0.5691742356952523,-0.1600885361450961
Connecticut,09013,Tolland County,34819,44006,80546,-9187,0.4322871402676731,0.5463461872718695,-0.11405904700419633
Connecticut,09015,Windham County,29141,26701,57077,2440,0.510555915692836,0.4678066471608529,0.042749268531983076
Delaware,10001,Kent County,41009,44552,87025,-3543,0.47123240448147086,0.5119448434357943,-0.040712438954323416
Delaware,10003,New Castle County,88364,195034,287633,-106670,0.3072109250329413,0.6780654514607156,-0.37085452642777433
Delaware,10005,Sussex County,71230,56682,129352,14548,0.5506679448327045,0.43819964128888617,0.11246830354381837
District of Columbia,11001,District of Columbia,18586,317323,344356,-298737,0.05397321376714795,0.9214969392140692,-0.8675237254469212
Florida,12001,Alachua County,50972,89704,142604,-38732,0.35743737903565115,0.629042663599899,-0.2716052845642479
Florida,12003,Baker County,11911,2037,14059,9874,0.8472153069208336,0.14488939469379045,0.7023259122270431
Florida,12005,Bay County,66097,25614,93024,40483,0.7105370657034744,0.2753482972136223,0.4351887684898521
Florida,12007,Bradford County,10334,3160,13632,7174,0.7580692488262911,0.2318075117370892,0.526261737089202
Florida,12009,Brevard County,207883,148549,360764,59334,0.5762298899003226,0.4117622600924704,0.16446762980785223
Florida,12011,Broward County,333409,618752,957672,-285343,0.3481452940046279,0.646100126139221,-0.29795483213459306
Florida,12013,Calhoun County,5274,1209,6526,4065,0.8081520073551947,0.1852589641434263,0.6228930432117683
Florida,12015,Charlotte County,73243,42273,116340,30970,0.629559910606842,0.36335740072202166,0.26620250988482036
Florida,12017,Citrus County,65352,27092,93208,38260,0.7011415329156295,0.29066174577289505,0.4104797871427345
Florida,12019,Clay County,84480,38317,124405,46163,0.6790723845504602,0.3080020899481532,0.37107029460230695
Florida,12021,Collier County,128950,77621,207818,51329,0.6204948560759895,0.37350470122895996,0.24699015484702957
Florida,12023,Columbia County,23836,8914,33042,14922,0.7213849040614975,0.2697778584831427,0.4516070455783548
Florida,12027,DeSoto County,8313,4259,12659,4054,0.6566869420965321,0.33644047713089503,0.3202464649656371
Florida,12029,Dixie County,6759,1365,8167,5394,0.8275988735153668,0.16713603526386678,0.6604628382515
Florida,12031,Duval County,233762,252556,492820,-18794,0.4743354571648878,0.5124710847774036,-0.038135627612515766
Florida,12033,Escambia County,96674,70929,170372,25745,0.5674289202451107,0.4163184091282605,0.1511105111168502
Florida,12035,Flagler County,43043,28161,71716,14882,0.6001868481231525,0.3926738803056501,0.2075129678175024
Florida,12037,Franklin County,4675,2120,6849,2555,0.6825813987443422,0.3095342385749745,0.37304716016936773
Florida,12039,Gadsden County,7465,16153,23762,-8688,0.31415705748674355,0.6797828465617373,-0.3656257890749937
Florida,12041,Gilchrist County,7895,1700,9685,6195,0.8151781104801239,0.17552916881775943,0.6396489416623645
Florida,12043,Glades County,3782,1385,5193,2397,0.7282880801078375,0.2667051800500674,0.46158290005777014
Florida,12045,Gulf County,6113,1985,8163,4128,0.7488668381722406,0.24317040303809873,0.505696435134142
Florida,12047,Hamilton County,3815,1963,5830,1852,0.6543739279588336,0.3367066895368782,0.31766723842195543
Florida,12049,Hardee County,6122,2298,8485,3824,0.7215085444902769,0.27083087802003536,0.45067766647024154
Florida,12051,Hendry County,7906,4929,12940,2977,0.6109737248840804,0.3809119010819165,0.2300618238021639
Florida,12053,Hernando County,70412,37519,108922,32893,0.6464442445052423,0.3444575016984631,0.3019867428067792
Florida,12055,Highlands County,34873,16938,52170,17935,0.668449300364194,0.3246693502012651,0.34377995016292895
Florida,12057,Hillsborough County,327398,376367,712063,-48969,0.459787968199443,0.5285585685536252,-0.06877060035418214
Florida,12059,Holmes County,8080,924,9068,7156,0.8910454344949272,0.10189677988531098,0.7891486546096163
Florida,12061,Indian River County,58872,37844,97484,21028,0.6039144885314514,0.3882072955561938,0.21570719297525753
Florida,12063,Jackson County,15488,6766,22419,8722,0.6908425888755074,0.3017975824077791,0.3890450064677283
Florida,12065,Jefferson County,4479,3897,8451,582,0.5299964501242457,0.46112886048988283,0.06886758963436285
Florida,12067,Lafayette County,3128,510,3658,2618,0.8551120831055221,0.1394204483324221,0.7156916347731
Florida,12069,Lake County,125859,83505,211314,42354,0.5956018058434368,0.3951702206195519,0.20043158522388488
Florida,12071,Lee County,233247,157695,393899,75552,0.5921492565353047,0.40034374293917985,0.19180551359612485
Florida,12073,Leon County,57453,103517,162929,-46064,0.35262599046210313,0.6353503673379202,-0.28272437687581703
Florida,12075,Levy County,16749,6205,23145,10544,0.7236552171095268,0.26809246057463815,0.4555627565348887
Florida,12077,Liberty County,2846,694,3561,2152,0.7992137040157259,0.19488907610221848,0.6043246279135074
Florida,12079,Madison County,5576,3747,9380,1829,0.594456289978678,0.39946695095948825,0.1949893390191898
Florida,12081,Manatee County,124987,90166,216958,34821,0.5760884595175103,0.41559195789046727,0.16049650162704304
Florida,12083,Marion County,127826,74858,204376,52968,0.6254452577602067,0.36627588366540104,0.2591693740948056
Florida,12085,Martin County,61168,36893,98726,24275,0.6195733646658428,0.3736908210603083,0.24588254360553446
Florida,12086,Miami-Dade County,532833,617864,1156816,-85031,0.4606030691138435,0.5341074120689894,-0.07350434295514585
Florida,12087,Monroe County,25693,21881,48029,3812,0.5349476358033688,0.4555789210685211,0.07936871473484769
Florida,12089,Nassau County,42566,15564,58811,27002,0.7237761643230008,0.2646443692506504,0.45913179507235047
Florida,12091,Okaloosa County,79798,34248,116373,45550,0.6857088843632114,0.29429506844371117,0.39141381591950025
Florida,12093,Okeechobee County,11470,4390,15954,7080,0.7189419581296227,0.2751661025448163,0.44377585558480637
Florida,12095,Orange County,245398,395014,647403,-149616,0.37904983449258034,0.6101516366158328,-0.2311018021232525
Florida,12097,Osceola County,73480,97297,172436,-23817,0.4261291145700434,0.5642499246097102,-0.13812081003966686
Florida,12099,Palm Beach County,334711,433572,773158,-98861,0.43291410035206257,0.5607805907718733,-0.12786649041981069
Florida,12101,Pasco County,179621,119073,301970,60548,0.5948306123124814,0.39432062787694144,0.2005099844355399
Florida,12103,Pinellas County,276209,277450,559715,-1241,0.493481503979704,0.49569870380461484,-0.002217199824910865
Florida,12105,Polk County,194586,145049,343256,49537,0.5668830260796607,0.42256799589810523,0.14431503018155545
Florida,12107,Putnam County,25514,10527,36373,14987,0.7014543754983091,0.2894179748714706,0.41203640062683855
Florida,12109,St. Johns County,110946,63850,176622,47096,0.6281550429731291,0.3615064940947334,0.2666485488783957
Florida,12111,St. Lucie County,86831,84137,172169,2694,0.5043358560484176,0.48868843984689464,0.015647416201522935
Florida,12113,Santa Rosa County,77385,27612,106928,49773,0.7237112823582224,0.258229836899596,0.46548144545862635
Florida,12115,Sarasota County,148370,120110,270575,28260,0.5483507345467985,0.4439064954264067,0.1044442391203918
Florida,12117,Seminole County,125241,132528,260815,-7287,0.48019093993827044,0.5081302839177194,-0.027939343979448972
Florida,12119,Sumter County,62761,29341,92485,33420,0.6786073417310915,0.3172514461804617,0.3613558955506298
Florida,12121,Suwannee County,16410,4485,21057,11925,0.7793132924918079,0.21299330388944293,0.566319988602365
Florida,12123,Taylor County,7751,2299,10127,5452,0.7653796780882789,0.2270168855534709,0.538362792534808
Florida,12125,Union County,5133,1053,6245,4080,0.821937550040032,0.16861489191353082,0.6533226581265011
Florida,12127,Volusia County,173821,130575,307439,43246,0.5653837021327808,0.4247183994223244,0.14066530271045635
Florida,12129,Wakulla County,12874,5351,18404,7523,0.6995218430775918,0.2907520104325147,0.4087698326450771
Florida,12131,Walton County,32947,10338,43711,22609,0.7537461966095491,0.23650797282148658,0.5172382237880625
Florida,12133,Washington County,9876,2347,12327,7529,0.8011681674373327,0.19039506773748682,0.6107730996998458
Georgia,13001,Appling County,6570,1784,8390,4786,0.7830750893921334,0.21263408820023838,0.570441001191895
Georgia,13003,Atkinson County,2300,825,3155,1475,0.7290015847860539,0.26148969889064977,0.46751188589540416
Georgia,13005,Bacon County,4017,625,4667,3392,0.8607242339832869,0.13391900578530105,0.7268052281979859
Georgia,13007,Baker County,897,652,1555,245,0.5768488745980708,0.4192926045016077,0.15755627009646306
Georgia,13009,Baldwin County,8903,9140,18251,-237,0.48780888718426385,0.500794477014958,-0.0129855898306942
Georgia,13011,Banks County,7795,932,8801,6863,0.885694807408249,0.1058970571525963,0.7797977502556527
Georgia,13013,Barrow County,26804,10453,37921,16351,0.7068378998444134,0.2756520133962712,0.43118588644814215
Georgia,13015,Bartow County,37672,12091,50464,25581,0.7465123652504756,0.23959654407102093,0.5069158211794547
Georgia,13017,Ben Hill County,4111,2393,6564,1718,0.6262949421084705,0.3645642900670323,0.2617306520414382
Georgia,13019,Berrien County,6419,1269,7743,5150,0.8290068448921607,0.16388996512979465,0.6651168797623661
Georgia,13021,Bibb County,26559,43408,70714,-16849,0.3755833356902452,0.613852985264587,-0.23826964957434177
Georgia,13023,Bleckley County,4329,1312,5708,3017,0.7584092501751927,0.22985283812193413,0.5285564120532585
Georgia,13025,Brantley County,6993,700,7749,6293,0.9024390243902439,0.09033423667570009,0.8121047877145439
Georgia,13027,Brooks County,4261,2791,7101,1470,0.6000563300943529,0.39304323334741587,0.20701309674693702
Georgia,13029,Bryan County,14240,6738,21335,7502,0.6674478556362784,0.31581907663463793,0.35162877900164047
Georgia,13031,Bulloch County,18387,11248,30090,7139,0.6110667996011964,0.3738118976404121,0.23725490196078425
Georgia,13033,Burke County,5400,5208,10683,192,0.5054759898904801,0.4875035102499298,0.017972479640550376
Georgia,13035,Butts County,8406,3274,11771,5132,0.71412794155127,0.27814119446096336,0.43598674709030666
Georgia,13037,Calhoun County,923,1263,2198,-340,0.41992720655141036,0.5746132848043676,-0.15468607825295722
Georgia,13039,Camden County,15249,7967,23686,7282,0.6437980241492866,0.33635903065101747,0.3074389934982691
Georgia,13043,Candler County,3133,1269,4431,1864,0.707063868201309,0.2863913337846987,0.42067253441661023
Georgia,13045,Carroll County,37476,16236,54472,21240,0.6879864884711412,0.29806138933764137,0.3899250991334998
Georgia,13047,Catoosa County,25167,6932,32593,18235,0.7721596661859909,0.21268370509005002,0.5594759610959408
Georgia,13049,Charlton County,3419,1105,4568,2314,0.7484676007005254,0.2419001751313485,0.5065674255691769
Georgia,13051,Chatham County,53232,78247,133408,-25015,0.3990165507315903,0.586524046533941,-0.18750749580235065
Georgia,13053,Chattahoochee County,880,667,1582,213,0.5562579013906448,0.4216182048040455,0.1346396965865993
Georgia,13055,Chattooga County,8064,1854,10050,6210,0.8023880597014925,0.18447761194029852,0.617910447761194
Georgia,13057,Cherokee County,99585,42779,144815,56806,0.6876704761247109,0.2954044815799468,0.3922659945447641
Georgia,13059,Clarke County,14450,36055,51346,-21605,0.28142406419195265,0.7021968605149379,-0.42077279632298525
Georgia,13061,Clay County,637,791,1435,-154,0.44390243902439025,0.551219512195122,-0.10731707317073175
Georgia,13063,Clayton County,15811,95466,112330,-79655,0.14075491854357697,0.8498709160509214,-0.7091159975073444
Georgia,13065,Clinch County,2105,744,2861,1361,0.7357567284166375,0.2600489339391821,0.4757077944774554
Georgia,13067,Cobb County,165436,221847,393728,-56411,0.42017839726918077,0.5634524341677504,-0.1432740368985696
Georgia,13069,Coffee County,10578,4511,15214,6067,0.6952806625476535,0.29650322071776,0.39877744182989355
Georgia,13071,Colquitt County,11777,4190,16086,7587,0.7321273156782295,0.26047494715902025,0.4716523685192093
Georgia,13073,Columbia County,50013,29232,80575,20781,0.6207012100527459,0.3627924294135898,0.2579087806391561
Georgia,13075,Cook County,4900,2059,7035,2841,0.6965174129353234,0.29267945984363897,0.40383795309168447
Georgia,13077,Coweta County,51501,24210,76799,27291,0.6705946692014219,0.315238479667704,0.35535618953371784
Georgia,13079,Crawford County,4428,1615,6102,2813,0.7256637168141593,0.2646673221894461,0.4609963946247132
Georgia,13081,Crisp County,4985,2982,8033,2003,0.6205651686791983,0.3712187227685796,0.24934644591061872
Georgia,13083,Dade County,6066,1261,7434,4805,0.8159806295399515,0.16962604250739843,0.6463545870325531
Georgia,13085,Dawson County,13398,2486,16081,10912,0.833157141968783,0.15459237609601392,0.678564765872769
Georgia,13087,Decatur County,6755,4782,11625,1973,0.5810752688172043,0.41135483870967743,0.16972043010752685
Georgia,13089,DeKalb County,58377,308162,370746,-249785,0.1574582058875888,0.8311944026368457,-0.673736196749257
Georgia,13091,Dodge County,5843,2172,8071,3671,0.7239499442448272,0.26911163424606616,0.454838309998761
Georgia,13093,Dooly County,2159,1911,4105,248,0.5259439707673569,0.46552984165651645,0.06041412911084043
Georgia,13095,Dougherty County,10441,24568,35287,-14127,0.29588800408082294,0.696233740470995,-0.400345736390172
Georgia,13097,Douglas County,25454,42814,69106,-17360,0.3683327062773131,0.6195409949931988,-0.2512082887158857
Georgia,13099,Early County,2710,2450,5188,260,0.5223592906707787,0.47224363916730916,0.05011565150346953
Georgia,13101,Echols County,1256,167,1441,1089,0.871616932685635,0.11589174184594032,0.7557251908396947
Georgia,13103,Effingham County,23361,7718,31571,15643,0.7399512210572994,0.2444648569890089,0.4954863640682905
Georgia,13105,Elbert County,6226,2879,9171,3347,0.6788790753462,0.31392432668193215,0.3649547486642678
Georgia,13107,Emanuel County,6553,2886,9505,3667,0.6894266175697001,0.3036296685954761,0.38579694897422406
Georgia,13109,Evans County,2888,1324,4247,1564,0.6800094184129974,0.3117494702142689,0.36825994819872854
Georgia,13111,Fannin County,12169,2570,14849,9599,0.8195164657552697,0.17307562798841672,0.646440837766853
Georgia,13113,Fayette County,37956,33062,71994,4894,0.527210600883407,0.4592327138372642,0.06797788704614277
Georgia,13115,Floyd County,28906,11917,41341,16989,0.6992090176822041,0.28826104835393435,0.41094796932826977
Georgia,13117,Forsyth County,85123,42208,129311,42915,0.65828119804193,0.326406879538477,0.33187431850345295
Georgia,13119,Franklin County,9069,1593,10765,7476,0.8424523920111472,0.14797956339990712,0.69447282861124
Georgia,13121,Fulton County,137247,380212,523779,-242965,0.2620322693349676,0.7259015729916625,-0.4638693036566949
Georgia,13123,Gilmer County,13429,2932,16525,10497,0.8126475037821482,0.17742813918305597,0.6352193645990922
Georgia,13125,Glascock County,1402,155,1565,1247,0.8958466453674121,0.09904153354632587,0.7968051118210863
Georgia,13127,Glynn County,25617,15882,41988,9735,0.6101028865390111,0.3782509288368105,0.23185195770220063
Georgia,13129,Gordon County,19405,4384,24033,15021,0.8074314484250822,0.18241584487995674,0.6250156035451254
Georgia,13131,Grady County,7034,3619,10707,3415,0.6569533949752498,0.33800317549266834,0.3189502194825815
Georgia,13133,Greene County,7066,4087,11244,2979,0.6284240483813589,0.36348274635361083,0.26494130202774807
Georgia,13135,Gwinnett County,166400,241994,414023,-75594,0.4019100388142688,0.5844940981539672,-0.18258405933969846
Georgia,13137,Habersham County,16637,3562,20431,13075,0.8143017962899516,0.17434291028339288,0.6399588860065587
Georgia,13139,Hall County,64183,25033,90537,39150,0.7089145874062538,0.27649469277753846,0.43241989462871533
Georgia,13141,Hancock County,1154,2976,4153,-1822,0.2778714182518661,0.7165904165663376,-0.4387189983144715
Georgia,13143,Haralson County,12330,1791,14246,10539,0.8655061069773972,0.12571950021058542,0.7397866067668117
Georgia,13145,Harris County,14319,5457,19991,8862,0.7162723225451453,0.27297283777699966,0.4432994847681456
Georgia,13147,Hart County,9465,3157,12728,6308,0.7436360779384035,0.24803582652419862,0.49560025141420483
Georgia,13149,Heard County,4519,824,5394,3695,0.8377827215424546,0.15276232851316277,0.6850203930292919
Georgia,13151,Henry County,48259,73443,122998,-25184,0.39235597326785804,0.5971072700369112,-0.20475129676905318
Georgia,13153,Houston County,41540,32239,74838,9301,0.5550656083807691,0.4307838263983538,0.12428178198241535
Georgia,13155,Irwin County,3134,1008,4168,2126,0.7519193857965452,0.2418426103646833,0.5100767754318618
Georgia,13157,Jackson County,29502,7642,37675,21860,0.7830656934306569,0.2028400796284008,0.5802256138022561
Georgia,13159,Jasper County,5822,1761,7644,4061,0.7616431187859759,0.23037676609105182,0.5312663526949241
Georgia,13161,Jeff Davis County,4695,1028,5771,3667,0.8135505111765725,0.17813203950788425,0.6354184716686883
Georgia,13163,Jefferson County,3537,4058,7639,-521,0.463018719727713,0.5312213640528866,-0.06820264432517353
Georgia,13165,Jenkins County,2161,1266,3455,895,0.6254703328509407,0.36642547033285094,0.2590448625180897
Georgia,13167,Johnson County,2850,1222,4100,1628,0.6951219512195121,0.29804878048780487,0.3970731707317073
Georgia,13169,Jones County,9940,4882,14934,5058,0.6655952859247355,0.3269050488817464,0.3386902370429891
Georgia,13171,Lamar County,6331,2620,9045,3711,0.6999447208402432,0.2896627971254837,0.41028192371475947
Georgia,13173,Lanier County,2509,1019,3576,1490,0.7016219239373602,0.2849552572706935,0.41666666666666674
Georgia,13175,Laurens County,14493,8074,22731,6419,0.6375874356605516,0.3551977475693986,0.28238968809115306
Georgia,13177,Lee County,12007,4558,16714,7449,0.7183798013641259,0.27270551633361256,0.4456742850305134
Georgia,13179,Liberty County,7959,13104,21394,-5145,0.37202019257735813,0.6125081798635131,-0.240487987286155
Georgia,13181,Lincoln County,3173,1432,4641,1741,0.6836888601594484,0.3085541909071321,0.3751346692523163
Georgia,13183,Long County,3527,2035,5657,1492,0.6234753402863709,0.35973130634611983,0.26374403394025103
Georgia,13185,Lowndes County,25692,20116,46355,5576,0.5542444180778773,0.433955344623018,0.12028907345485929
Georgia,13187,Lumpkin County,12163,3126,15531,9037,0.7831433906380787,0.2012748696156075,0.5818685210224712
Georgia,13189,McDuffie County,6169,4168,10455,2001,0.5900526064084171,0.39866092778574846,0.1913916786226686
Georgia,13191,McIntosh County,4016,2612,6696,1404,0.5997610513739546,0.3900836320191159,0.20967741935483875
Georgia,13193,Macon County,1783,2858,4663,-1075,0.3823718636071199,0.6129101436843234,-0.2305382800772035
Georgia,13195,Madison County,11326,3411,14937,7915,0.7582513222199906,0.22835910825466962,0.5298922139653209
Georgia,13197,Marion County,2275,1312,3625,963,0.6275862068965518,0.3619310344827586,0.26565517241379316
Georgia,13199,Meriwether County,6524,4287,10877,2237,0.5997977383469707,0.3941344120621495,0.2056633262848212
Georgia,13201,Miller County,2066,748,2834,1318,0.7290049400141143,0.2639378969654199,0.4650670430486944
Georgia,13205,Mitchell County,4935,3993,8962,942,0.5506583351930373,0.4455478687792903,0.105110466413747
Georgia,13207,Monroe County,11057,4385,15590,6672,0.7092366901860166,0.2812700449005773,0.4279666452854394
Georgia,13209,Montgomery County,2960,980,3967,1980,0.7461557852281321,0.24703806402823292,0.49911772119989917
Georgia,13211,Morgan County,8231,3353,11706,4878,0.7031436869981206,0.28643430719289253,0.41670937980522804
Georgia,13213,Murray County,12944,2301,15389,10643,0.8411202807199948,0.1495223861199558,0.691597894600039
Georgia,13215,Muscogee County,30107,49446,80514,-19339,0.37393496783168145,0.6141292197630226,-0.24019425193134114
Georgia,13217,Newton County,23869,29789,54234,-5920,0.44011136925176086,0.5492679868717041,-0.10915661761994322
Georgia,13219,Oconee County,16595,8162,25168,8433,0.6593690400508583,0.3243006993006993,0.33506834075015896
Georgia,13221,Oglethorpe County,5592,2439,8133,3153,0.6875691626706013,0.299889339727038,0.3876798229435633
Georgia,13223,Paulding County,54517,29695,85372,24822,0.6385817364006935,0.34783067047743993,0.29075106592325356
Georgia,13225,Peach County,6506,5922,12553,584,0.5182824822751534,0.4717597387078786,0.046522743567274816
Georgia,13227,Pickens County,14110,2824,17167,11286,0.8219257878487797,0.1645016601619386,0.6574241276868411
Georgia,13229,Pierce County,7898,1100,9047,6798,0.8729965734497623,0.12158726649718139,0.7514093069525809
Georgia,13231,Pike County,9127,1505,10720,7622,0.8513992537313433,0.14039179104477612,0.7110074626865672
Georgia,13233,Polk County,13587,3657,17396,9930,0.781041618762934,0.21022074040009198,0.570820878362842
Georgia,13235,Pulaski County,2815,1230,4081,1585,0.6897819161970106,0.3013967164910561,0.3883851997059545
Georgia,13237,Putnam County,8291,3448,11855,4843,0.699367355546183,0.2908477435681147,0.4085196119780683
Georgia,13239,Quitman County,604,497,1106,107,0.546112115732369,0.44936708860759494,0.09674502712477401
Georgia,13241,Rabun County,7474,1984,9568,5490,0.7811454849498328,0.20735785953177258,0.5737876254180603
Georgia,13243,Randolph County,1390,1671,3073,-281,0.4523267165636186,0.5437683045883501,-0.09144158802473151
Georgia,13245,Richmond County,26780,59119,87009,-32339,0.307784252203795,0.6794584468273397,-0.3716741946235447
Georgia,13247,Rockdale County,13014,31237,44681,-18223,0.29126474340323627,0.6991114791522124,-0.4078467357489761
Georgia,13249,Schley County,1800,462,2275,1338,0.7912087912087912,0.20307692307692307,0.5881318681318681
Georgia,13251,Screven County,3915,2661,6627,1254,0.5907650520597555,0.40153915799004075,0.18922589406971474
Georgia,13253,Seminole County,2613,1256,3888,1357,0.6720679012345679,0.3230452674897119,0.34902263374485604
Georgia,13255,Spalding County,18104,11828,30211,6276,0.5992519281056569,0.3915130250570984,0.20773890304855847
Georgia,13257,Stephens County,9367,2386,11885,6981,0.7881363062684056,0.20075725704669753,0.587379049221708
Georgia,13259,Stewart County,801,1182,1990,-381,0.40251256281407033,0.5939698492462312,-0.19145728643216087
Georgia,13261,Sumter County,5733,6314,12148,-581,0.47192953572604546,0.5197563384919328,-0.047826802765887355
Georgia,13263,Talbot County,1392,2114,3522,-722,0.39522998296422485,0.6002271436683703,-0.20499716070414542
Georgia,13265,Taliaferro County,360,561,928,-201,0.3879310344827586,0.6045258620689655,-0.2165948275862069
Georgia,13267,Tattnall County,6054,2062,8185,3992,0.7396456933414783,0.25192425167990223,0.4877214416615761
Georgia,13269,Taylor County,2420,1388,3842,1032,0.6298802706923478,0.3612701717855284,0.26861009890681936
Georgia,13271,Telfair County,2825,1488,4334,1337,0.6518227964928472,0.34333179510844486,0.3084910013844024
Georgia,13273,Terrell County,2004,2376,4416,-372,0.453804347826087,0.5380434782608695,-0.08423913043478254
Georgia,13275,Thomas County,12969,8708,21872,4261,0.5929498902706657,0.398134601316752,0.1948152889539137
Georgia,13277,Tift County,10784,5318,16279,5466,0.6624485533509429,0.32667854290804105,0.33577001044290183
Georgia,13279,Toombs County,7873,2938,10914,4935,0.7213670514934946,0.26919552867876123,0.45217152281473333
Georgia,13281,Towns County,6384,1550,7979,4834,0.800100263190876,0.19425993232234615,0.6058403308685298
Georgia,13283,Treutlen County,2101,952,3077,1149,0.682807929801755,0.30939226519337015,0.3734156646083848
Georgia,13285,Troup County,18142,11577,30047,6565,0.6037873997404067,0.38529636902186576,0.21849103071854098
Georgia,13287,Turner County,2349,1409,3791,940,0.619625428646795,0.3716697441308362,0.24795568451595884
Georgia,13289,Twiggs County,2370,2044,4444,326,0.5333033303330333,0.45994599459945995,0.07335733573357339
Georgia,13291,Union County,12650,2800,15558,9850,0.813086514976218,0.17997171872991388,0.6331147962463041
Georgia,13293,Upson County,8606,4203,12905,4403,0.6668733049205734,0.3256877179387834,0.34118558698178997
Georgia,13295,Walker County,23173,5770,29354,17403,0.7894324453226136,0.1965660557334605,0.592866389589153
Georgia,13297,Walton County,37839,12683,51093,25156,0.7405906875697258,0.24823361321511753,0.4923570743546083
Georgia,13299,Ware County,9903,4169,14189,5734,0.6979350200859821,0.29381915568398054,0.40411586440200153
Georgia,13301,Warren County,1166,1468,2650,-302,0.44,0.5539622641509434,-0.1139622641509434
Georgia,13303,Washington County,4668,4743,9477,-75,0.49256093700538145,0.5004748338081672,-0.007913896802785703
Georgia,13305,Wayne County,9987,2688,12779,7299,0.781516550590813,0.21034509742546365,0.5711714531653493
Georgia,13307,Webster County,748,640,1391,108,0.5377426312005751,0.46010064701653486,0.07764198418404022
Georgia,13309,Wheeler County,1583,689,2285,894,0.6927789934354486,0.3015317286652079,0.3912472647702407
Georgia,13311,White County,12222,2411,14816,9811,0.8249190064794817,0.1627294816414687,0.662189524838013
Georgia,13313,Whitfield County,25644,10680,36766,14964,0.6974922482728608,0.29048577490072347,0.40700647337213736
Georgia,13315,Wilcox County,2402,861,3279,1541,0.7325404086611772,0.262580054894785,0.4699603537663922
Georgia,13317,Wilkes County,2823,2160,5030,663,0.5612326043737574,0.4294234592445328,0.13180914512922465
Georgia,13319,Wilkinson County,2665,2074,4770,591,0.5587002096436059,0.4348008385744235,0.12389937106918242
Georgia,13321,Worth County,6830,2395,9285,4435,0.7355950457727517,0.2579429186860528,0.4776521270866989
Hawaii,15001,Hawaii County,26897,58731,87814,-31834,0.3062951237843624,0.6688113512651741,-0.3625162274808117
Hawaii,15003,Honolulu County,136259,238869,382114,-102610,0.3565925352120048,0.6251249627074643,-0.2685324274954595
Hawaii,15007,Kauai County,11582,21225,33497,-9643,0.3457623070722751,0.6336388333283578,-0.2878765262560827
Hawaii,15009,Maui County,22126,47305,71044,-25179,0.311440797252407,0.6658549631214459,-0.3544141658690389
Idaho,16001,Ada County,130699,120539,259389,10160,0.5038725620593009,0.46470359190250937,0.039168970156791494
Idaho,16003,Adams County,1941,591,2586,1350,0.7505800464037123,0.228538283062645,0.5220417633410673
Idaho,16005,Bannock County,23331,14682,39553,8649,0.5898667610547872,0.37119813920562283,0.21866862184916436
Idaho,16007,Bear Lake County,2914,350,3315,2564,0.8790346907993967,0.10558069381598793,0.7734539969834088
Idaho,16009,Benewah County,3878,977,4973,2901,0.779810979288156,0.1964608887995174,0.5833500904886386
Idaho,16011,Bingham County,15295,4124,20094,11171,0.7611724893002887,0.20523539364984572,0.555937095650443
Idaho,16013,Blaine County,4031,8919,13288,-4888,0.3033564118001204,0.671207104154124,-0.3678506923540036
Idaho,16015,Boise County,3485,1204,4820,2281,0.7230290456431535,0.24979253112033195,0.47323651452282156
Idaho,16017,Bonner County,18369,8310,27352,10059,0.6715779467680608,0.30381690552793217,0.36776104124012865
Idaho,16019,Bonneville County,37805,14254,53995,23551,0.700157421983517,0.26398740624131867,0.4361700157421984
Idaho,16021,Boundary County,4937,1220,6313,3717,0.7820370663709805,0.19325201964200855,0.5887850467289719
Idaho,16023,Butte County,1202,188,1415,1014,0.8494699646643109,0.13286219081272085,0.71660777385159
Idaho,16025,Camas County,507,149,754,358,0.6724137931034483,0.1976127320954907,0.4748010610079576
Idaho,16027,Canyon County,61759,25881,90438,35878,0.6828877241867357,0.2861739534266569,0.3967137707600788
Idaho,16029,Caribou County,2906,431,3416,2475,0.8507025761124122,0.12617096018735363,0.7245316159250585
Idaho,16031,Cassia County,7907,1464,9629,6443,0.8211652300342714,0.15204071035413855,0.6691245196801329
Idaho,16033,Clark County,264,41,311,223,0.8488745980707395,0.13183279742765272,0.7170418006430868
Idaho,16035,Clearwater County,3453,877,4419,2576,0.781398506449423,0.1984611903145508,0.5829373161348722
Idaho,16037,Custer County,2089,603,2739,1486,0.7626871120847024,0.22015334063526834,0.542533771449434
Idaho,16039,Elmore County,7246,2601,10205,4645,0.7100440960313572,0.254875061244488,0.4551690347868692
Idaho,16041,Franklin County,5845,657,6664,5188,0.8771008403361344,0.09858943577430973,0.7785114045618247
Idaho,16043,Fremont County,5548,998,6719,4550,0.8257181128144069,0.14853400803691025,0.6771841047774967
Idaho,16045,Gem County,7951,1803,9958,6148,0.7984535047198232,0.1810604539064069,0.6173930508134163
Idaho,16047,Gooding County,4659,1256,6050,3403,0.7700826446280992,0.20760330578512395,0.5624793388429752
Idaho,16049,Idaho County,7826,1561,9602,6265,0.8150385336388253,0.16257029785461363,0.6524682357842116
Idaho,16051,Jefferson County,12099,1661,14173,10438,0.8536654201651026,0.11719466591406195,0.7364707542510407
Idaho,16053,Jerome County,5734,1893,7812,3841,0.7339989759344598,0.2423195084485407,0.4916794674859192
Idaho,16055,Kootenai County,62837,24312,89878,38525,0.6991366074011438,0.27050001112619326,0.42863659627495054
Idaho,16057,Latah County,9472,10236,20570,-764,0.46047642197374816,0.4976178901312591,-0.03714146815751096
Idaho,16059,Lemhi County,3592,1032,4738,2560,0.7581257914731955,0.2178134233853947,0.5403123680878008
Idaho,16061,Lewis County,1489,349,1870,1140,0.7962566844919786,0.18663101604278076,0.6096256684491979
Idaho,16063,Lincoln County,1469,414,1940,1055,0.7572164948453608,0.2134020618556701,0.5438144329896907
Idaho,16065,Madison County,13559,2666,17112,10893,0.7923679289387564,0.15579710144927536,0.636570827489481
Idaho,16067,Minidoka County,6265,1550,7993,4715,0.7838108344801702,0.1939196797197548,0.5898911547604154
Idaho,16069,Nez Perce County,13738,6686,20967,7052,0.6552201077884294,0.31888205274955883,0.3363380550388706
Idaho,16071,Oneida County,2148,249,2451,1899,0.8763769889840881,0.10159118727050184,0.7747858017135862
Idaho,16073,Owyhee County,3819,816,4742,3003,0.8053563897089836,0.1720792914382117,0.6332770982707718
Idaho,16075,Payette County,8862,2161,11293,6701,0.7847339059594439,0.1913574780837687,0.5933764278756752
Idaho,16077,Power County,2116,865,3086,1251,0.6856772521062865,0.280298120544394,0.4053791315618925
Idaho,16079,Shoshone County,4216,1693,6049,2523,0.6969747065630683,0.27988097206149776,0.4170937345015705
Idaho,16081,Teton County,2858,3318,6347,-460,0.4502914762880101,0.5227666614148416,-0.07247518512683154
Idaho,16083,Twin Falls County,25897,9391,36680,16506,0.7060250817884406,0.2560250817884406,0.45
Idaho,16085,Valley County,3947,2976,7063,971,0.5588276936146114,0.4213507008353391,0.13747699277927228
Idaho,16087,Washington County,4154,1073,5344,3081,0.7773203592814372,0.20078592814371257,0.5765344311377246
Illinois,17001,Adams County,24220,8633,33527,15587,0.7224028395024905,0.25749396009186626,0.46490887941062425
Illinois,17003,Alexander County,1486,1114,2625,372,0.5660952380952381,0.42438095238095236,0.14171428571428574
Illinois,17005,Bond County,5625,2288,8144,3337,0.6906925343811395,0.28094302554027506,0.4097495088408645
Illinois,17007,Boone County,13883,10542,24979,3341,0.5557868609632091,0.4220345089875495,0.13375235197565954
Illinois,17009,Brown County,1931,486,2525,1445,0.7647524752475248,0.19247524752475248,0.5722772277227723
Illinois,17011,Bureau County,10411,6669,17434,3742,0.5971664563496616,0.38252839279568657,0.21463806355397502
Illinois,17013,Calhoun County,2046,677,2773,1369,0.7378290659935088,0.2441399206635413,0.49368914532996755
Illinois,17015,Carroll County,5105,2748,8024,2357,0.6362163509471586,0.3424725822532403,0.2937437686939183
Illinois,17017,Cass County,3625,1615,5326,2010,0.6806233571160345,0.3032294404806609,0.3773939166353736
Illinois,17019,Champaign County,35285,57067,95568,-21782,0.36921354428260506,0.5971350242759083,-0.2279214799933032
Illinois,17021,Christian County,11563,4335,16204,7228,0.7135892372253765,0.2675265366576154,0.4460627005677611
Illinois,17023,Clark County,6226,1993,8355,4233,0.745182525433872,0.23853979652902454,0.5066427289048474
Illinois,17025,Clay County,5629,1129,6899,4500,0.815915350050732,0.16364690534860124,0.6522684447021307
Illinois,17027,Clinton County,14304,4493,19214,9811,0.7444571666493182,0.23383990840012492,0.5106172582491932
Illinois,17029,Coles County,14037,8067,22606,5970,0.6209413430062816,0.35685216314252854,0.264089179863753
Illinois,17031,Cook County,558269,1725973,2321399,-1167704,0.24048817114162624,0.7435055326550929,-0.5030173615134667
Illinois,17033,Crawford County,7043,2202,9441,4841,0.7460014828937612,0.23323800444868129,0.51276347844508
Illinois,17035,Cumberland County,4601,1142,5850,3459,0.7864957264957265,0.19521367521367522,0.5912820512820514
Illinois,17037,DeKalb County,21905,24643,47989,-2738,0.4564587718018713,0.5135135135135135,-0.05705474171164221
Illinois,17039,De Witt County,5632,2191,8024,3441,0.7018943170488534,0.27305583250249255,0.42883848454636087
Illinois,17041,Douglas County,6227,2335,8760,3892,0.7108447488584475,0.2665525114155251,0.4442922374429224
Illinois,17043,DuPage County,193611,281222,485064,-87611,0.399145267428628,0.5797626704929659,-0.18061740306433793
Illinois,17045,Edgar County,6193,1887,8196,4306,0.7556124938994632,0.23023426061493413,0.525378233284529
Illinois,17047,Edwards County,2833,488,3368,2345,0.8411520190023754,0.14489311163895488,0.6962589073634204
Illinois,17049,Effingham County,15006,3716,19083,11290,0.7863543468008175,0.1947282921972436,0.5916260546035739
Illinois,17051,Fayette County,8055,1826,10076,6229,0.7994243747518857,0.1812227074235808,0.6182016673283048
Illinois,17053,Ford County,5048,1754,6967,3294,0.7245586335582029,0.25175828907707765,0.4728003444811253
Illinois,17055,Franklin County,13622,4760,18669,8862,0.7296587926509186,0.254968128983877,0.4746906636670416
Illinois,17057,Fulton County,9867,6503,16724,3364,0.5899904329107869,0.38884238220521405,0.20114805070557285
Illinois,17059,Gallatin County,2019,622,2675,1397,0.7547663551401869,0.23252336448598132,0.5222429906542055
Illinois,17061,Greene County,4770,1349,6227,3421,0.7660189497350249,0.21663722498795568,0.5493817247470693
Illinois,17063,Grundy County,16523,9626,26753,6897,0.6176129779837776,0.35981011475348557,0.257802863230292
Illinois,17065,Hamilton County,3432,824,4323,2608,0.7938931297709924,0.19060837381448067,0.6032847559565117
Illinois,17067,Hancock County,6906,2315,9383,4591,0.7360119364808697,0.2467227965469466,0.4892891399339231
Illinois,17069,Hardin County,1691,449,2162,1242,0.7821461609620721,0.20767807585568918,0.5744680851063829
Illinois,17071,Henderson County,2394,1187,3656,1207,0.6548140043763676,0.324671772428884,0.3301422319474836
Illinois,17073,Henry County,15300,9797,25700,5503,0.5953307392996109,0.3812062256809339,0.21412451361867701
Illinois,17075,Iroquois County,10877,2908,14044,7969,0.774494446026773,0.2070635146681857,0.5674309313585872
Illinois,17077,Jackson County,10890,11181,22716,-291,0.47939778129952454,0.4922081352350766,-0.012810353935552077
Illinois,17079,Jasper County,4494,1007,5586,3487,0.8045112781954887,0.18027210884353742,0.6242391693519513
Illinois,17081,Jefferson County,12476,4608,17436,7868,0.7155310851112641,0.264280798348245,0.45125028676301904
Illinois,17083,Jersey County,8712,2961,11960,5751,0.728428093645485,0.2475752508361204,0.4808528428093646
Illinois,17085,Jo Daviess County,7166,5109,12495,2057,0.5735094037615046,0.40888355342136856,0.16462585034013605
Illinois,17087,Johnson County,5059,1281,6450,3778,0.7843410852713179,0.1986046511627907,0.5857364341085272
Illinois,17089,Kane County,96775,130166,231876,-33391,0.4173566906449999,0.561360382273284,-0.14400369162828408
Illinois,17091,Kankakee County,28532,20271,50039,8261,0.5701952477067888,0.4051040188652851,0.16509122884150368
Illinois,17093,Kendall County,29492,33168,64205,-3676,0.45934117280585623,0.5165952807413753,-0.05725410793551905
Illinois,17095,Knox County,12009,10703,23205,1306,0.5175177763413058,0.46123680241327303,0.056280973928032774
Illinois,17097,Lake County,123594,204032,334156,-80438,0.3698691629059481,0.6105890661846562,-0.24071990327870812
Illinois,17099,LaSalle County,30113,22442,53683,7671,0.5609410800439618,0.4180466814447777,0.14289439859918412
Illinois,17101,Lawrence County,4886,1419,6422,3467,0.7608221737776394,0.22095920274057926,0.5398629710370602
Illinois,17103,Lee County,9630,6407,16440,3223,0.5857664233576643,0.3897201946472019,0.19604622871046234
Illinois,17105,Livingston County,12208,4615,17174,7593,0.710841970420403,0.2687201583789449,0.44212181204145806
Illinois,17107,Logan County,9136,3840,13294,5296,0.6872273205957575,0.2888521137355198,0.39837520686023775
Illinois,17109,McDonough County,7027,4992,12285,2035,0.571998371998372,0.40634920634920635,0.16564916564916565
Illinois,17111,McHenry County,82260,78154,164578,4106,0.4998237917583152,0.4748751351942544,0.02494865656406081
Illinois,17113,McLean County,40502,43933,87389,-3431,0.4634679421895204,0.5027291764409708,-0.039261234251450394
Illinois,17115,Macon County,28589,19847,49387,8742,0.5788770324174378,0.4018668880474619,0.17701014436997592
Illinois,17117,Macoupin County,16153,7365,24070,8788,0.6710843373493975,0.30598255089322807,0.3651017864561695
Illinois,17119,Madison County,76031,57836,137558,18195,0.5527195801043924,0.42044810189156573,0.13227147821282664
Illinois,17121,Marion County,12678,4524,17492,8154,0.7247884747313057,0.2586325177223874,0.4661559570089183
Illinois,17123,Marshall County,4197,2005,6345,2192,0.6614657210401891,0.31599684791174154,0.34546887312844754
Illinois,17125,Mason County,4654,1985,6766,2669,0.6878510198049069,0.29337865799586166,0.39447236180904527
Illinois,17127,Massac County,4997,1725,6818,3272,0.7329128776767381,0.2530067468465826,0.4799061308301555
Illinois,17129,Menard County,4764,2022,6954,2742,0.6850733390854185,0.2907679033649698,0.3943054357204486
Illinois,17131,Mercer County,5418,3280,8914,2138,0.6078079425622616,0.36796051155485754,0.23984743100740402
Illinois,17133,Monroe County,14142,6569,21206,7573,0.6668867301707064,0.3097708195793643,0.3571159105913421
Illinois,17135,Montgomery County,9544,3905,13761,5639,0.6935542475110821,0.2837729816147082,0.40978126589637387
Illinois,17137,Morgan County,9950,5076,15333,4874,0.6489271505902302,0.3310506750146742,0.317876475575556
Illinois,17139,Moultrie County,4964,1662,6744,3302,0.736061684460261,0.24644128113879005,0.48962040332147094
Illinois,17141,Ogle County,16248,9428,26340,6820,0.6168564920273348,0.35793470007593015,0.2589217919514047
Illinois,17143,Peoria County,38252,43578,83973,-5326,0.4555273718933467,0.5189525204530028,-0.06342514855965609
Illinois,17145,Perry County,7313,2612,10071,4701,0.7261443749379406,0.2593585542647205,0.4667858206732201
Illinois,17147,Piatt County,6248,3329,9851,2919,0.6342503299157446,0.33793523500152267,0.2963150949142219
Illinois,17149,Pike County,6332,1484,7965,4848,0.794978028876334,0.18631512868801003,0.6086629001883239
Illinois,17151,Pope County,1722,433,2175,1289,0.7917241379310345,0.19908045977011493,0.5926436781609196
Illinois,17153,Pulaski County,1699,891,2631,808,0.6457620676548841,0.338654503990878,0.3071075636640061
Illinois,17155,Putnam County,1993,1338,3390,655,0.587905604719764,0.39469026548672564,0.1932153392330384
Illinois,17157,Randolph County,11076,3592,14910,7484,0.7428571428571429,0.2409121395036888,0.501945003353454
Illinois,17159,Richland County,6089,1830,8063,4259,0.7551779734590103,0.22696266898176856,0.5282153044772417
Illinois,17161,Rock Island County,28603,36691,66817,-8088,0.4280796803208764,0.5491267192480955,-0.12104703892721913
Illinois,17163,St. Clair County,57150,68325,128104,-11175,0.44612190095547366,0.5333557109848248,-0.08723381002935116
Illinois,17165,Saline County,8103,2789,11089,5314,0.730724141040671,0.25151050590675444,0.4792136351339165
Illinois,17167,Sangamon County,53485,48917,104751,4568,0.5105917843266413,0.4669836087483652,0.04360817557827612
Illinois,17169,Schuyler County,2773,1068,3918,1705,0.7077590607452782,0.2725880551301684,0.43517100561510974
Illinois,17171,Scott County,2114,572,2741,1542,0.7712513681138271,0.20868296242247356,0.5625684056913536
Illinois,17173,Shelby County,9426,2504,12097,6922,0.7792014549061751,0.20699346945523683,0.5722079854509383
Illinois,17175,Stark County,2004,815,2886,1189,0.6943866943866944,0.2823977823977824,0.411988911988912
Illinois,17177,Stephenson County,12521,9055,22048,3466,0.5678973149492017,0.41069484760522496,0.15720246734397675
Illinois,17179,Tazewell County,42513,24819,69051,17694,0.6156753703784159,0.35942998653169395,0.25624538384672196
Illinois,17181,Union County,6161,2579,8904,3582,0.6919362084456424,0.2896451033243486,0.4022911051212938
Illinois,17183,Vermilion County,20725,10323,31642,10402,0.6549838821819102,0.3262436002781114,0.3287402819037988
Illinois,17185,Wabash County,4237,1253,5607,2984,0.7556625646513287,0.22347066167290885,0.5321919029784199
Illinois,17187,Warren County,4676,3090,7924,1586,0.5901060070671378,0.3899545683997981,0.2001514386673397
Illinois,17189,Washington County,6115,1641,7921,4474,0.7719984850397678,0.20717081176619115,0.5648276732735766
Illinois,17191,Wayne County,7176,1187,8499,5989,0.8443346276032474,0.13966348982233204,0.7046711377809154
Illinois,17193,White County,5791,1517,7431,4274,0.7793029201991657,0.20414479881577177,0.575158121383394
Illinois,17195,Whiteside County,14527,12253,27375,2274,0.5306666666666666,0.44759817351598175,0.08306849315068487
Illinois,17197,Will County,155116,183915,346266,-28799,0.4479677473387511,0.5311379113167334,-0.08317016397798227
Illinois,17199,Williamson County,22801,10206,33729,12595,0.6760058110231552,0.3025882771502268,0.37341753387292836
Illinois,17201,Winnebago County,60861,64056,127710,-3195,0.4765562602771905,0.5015738783180643,-0.025017618040873824
Illinois,17203,Woodford County,14799,6160,21498,8639,0.6883896176388501,0.2865382826309424,0.4018513350079077
Indiana,18001,Adams County,10686,3236,14209,7450,0.7520585544373285,0.22774297980153424,0.5243155746357943
Indiana,18003,Allen County,92083,73189,169082,18894,0.5446055759927136,0.432860978696727,0.11174459729598663
Indiana,18005,Bartholomew County,22410,12934,36235,9476,0.6184628121981509,0.35694770249758523,0.2615151097005657
Indiana,18007,Benton County,3007,1009,4114,1998,0.7309188138065144,0.2452600875060768,0.48565872630043755
Indiana,18009,Blackford County,3841,1376,5350,2465,0.7179439252336448,0.25719626168224297,0.46074766355140184
Indiana,18011,Boone County,22351,15244,38520,7107,0.5802440290758047,0.395742471443406,0.18450155763239873
Indiana,18013,Brown County,5777,3036,8981,2741,0.643246854470549,0.33804698808595923,0.30519986638458974
Indiana,18015,Carroll County,7086,2224,9495,4862,0.7462875197472354,0.2342285413375461,0.5120589784096893
Indiana,18017,Cass County,10552,4304,15198,6248,0.6943018818265562,0.2831951572575339,0.41110672456902225
Indiana,18019,Clark County,33668,23093,57869,10575,0.5817968169486254,0.3990564896576751,0.1827403272909503
Indiana,18021,Clay County,9499,2552,12267,6947,0.7743539577728866,0.20803782505910165,0.566316132713785
Indiana,18023,Clinton County,9334,3361,12949,5973,0.720827863155456,0.25955672252683604,0.46127114062861996
Indiana,18025,Crawford County,3483,1355,4944,2128,0.7044902912621359,0.2740695792880259,0.43042071197411
Indiana,18027,Daviess County,9576,2169,11954,7407,0.8010707712899447,0.18144554124142545,0.6196252300485193
Indiana,18029,Dearborn County,19528,5446,25383,14082,0.7693338060906906,0.21455304731513217,0.5547807587755584
Indiana,18031,Decatur County,9575,2439,12287,7136,0.7792789126719297,0.19850248229836412,0.5807764303735656
Indiana,18033,DeKalb County,14237,4966,19628,9271,0.7253413490931323,0.25300590992459754,0.47233543916853477
Indiana,18035,Delaware County,26827,20474,48191,6353,0.5566807080160195,0.42485111327841296,0.13182959473760658
Indiana,18037,Dubois County,15033,6292,21770,8741,0.6905374368396876,0.28902158934313277,0.40151584749655483
Indiana,18039,Elkhart County,46972,26108,74387,20864,0.6314544207993332,0.35097530482476774,0.2804791159745655
Indiana,18041,Fayette County,7755,2237,10136,5518,0.7650947119179163,0.22069850039463298,0.5443962115232833
Indiana,18043,Floyd County,23400,17511,41802,5889,0.5597818286206402,0.4189034017511124,0.14087842686952778
Indiana,18045,Fountain County,6154,1629,7986,4525,0.7705985474580516,0.20398196844477837,0.5666165790132732
Indiana,18047,Franklin County,9691,2137,12000,7554,0.8075833333333333,0.17808333333333334,0.6295
Indiana,18049,Fulton County,6694,2280,9147,4414,0.7318246419591122,0.24926205313217448,0.48256258882693776
Indiana,18051,Gibson County,11817,4023,16161,7794,0.7312047521811769,0.24893261555596807,0.4822721366252088
Indiana,18053,Grant County,18543,8015,27159,10528,0.6827570970948856,0.295113958540447,0.38764313855443866
Indiana,18055,Greene County,11103,3389,14784,7714,0.7510146103896104,0.22923430735930736,0.521780303030303
Indiana,18057,Hamilton County,101587,88390,193999,13197,0.5236470291083974,0.45562090526239823,0.06802612384599921
Indiana,18059,Hancock County,28996,12895,42911,16101,0.6757241732889003,0.30050569783971476,0.3752184754491856
Indiana,18061,Harrison County,14565,5343,20236,9222,0.7197568689464321,0.2640343941490413,0.4557224747973908
Indiana,18063,Hendricks County,53802,32604,88505,21198,0.6078978588780295,0.36838596689452574,0.23951189198350376
Indiana,18065,Henry County,15043,5544,21030,9499,0.7153114598193058,0.263623395149786,0.4516880646695198
Indiana,18067,Howard County,26449,13303,40630,13146,0.6509721880383953,0.327418163918287,0.3235540241201083
Indiana,18069,Huntington County,13147,4255,17829,8892,0.7373941331538505,0.23865612204834818,0.4987380111055023
Indiana,18071,Jackson County,14555,4302,19238,10253,0.7565755276016218,0.22361991891048966,0.5329556086911322
Indiana,18073,Jasper County,11383,3798,15475,7585,0.7355735056542811,0.2454281098546042,0.490145395799677
Indiana,18075,Jay County,6361,1926,8461,4435,0.7518023874246543,0.22763266753338848,0.5241697198912658
Indiana,18077,Jefferson County,9663,4731,14697,4932,0.6574811185956317,0.32190242906715655,0.3355786895284752
Indiana,18079,Jennings County,9490,2523,12251,6967,0.774630642396539,0.20594237205126112,0.5686882703452779
Indiana,18081,Johnson County,51219,24736,77618,26483,0.6598855935478883,0.31868896390012624,0.3411966296477621
Indiana,18083,Knox County,11655,4067,16011,7588,0.7279370432827431,0.2540128661545188,0.4739241771282243
Indiana,18085,Kosciusko County,26499,8364,35787,18135,0.7404644144521754,0.23371615391063794,0.5067482605415374
Indiana,18087,LaGrange County,8110,2355,10633,5755,0.7627198344775699,0.22148029718799964,0.5412395372895702
Indiana,18089,Lake County,91760,124870,219956,-33110,0.41717434395970104,0.5677044499809053,-0.15053010602120426
Indiana,18091,LaPorte County,25997,22427,49392,3570,0.5263402980239715,0.45406138645934563,0.0722789115646259
Indiana,18093,Lawrence County,15601,4961,21025,10640,0.7420214030915576,0.23595719381688465,0.506064209274673
Indiana,18095,Madison County,31215,19524,51793,11691,0.6026876218794045,0.3769621377406213,0.22572548413878318
Indiana,18097,Marion County,134175,247772,389619,-113597,0.34437488931494614,0.6359340791901832,-0.29155918987523705
Indiana,18099,Marshall County,13844,5712,19927,8132,0.6947357856175039,0.28664625884478345,0.4080895267727205
Indiana,18101,Martin County,4029,1011,5144,3018,0.7832426127527217,0.19653965785381025,0.5867029548989114
Indiana,18103,Miami County,10925,3235,14473,7690,0.7548538658191114,0.22351965729289022,0.5313342085262212
Indiana,18105,Monroe County,22071,39861,63151,-17790,0.3494956532754826,0.6312014061535051,-0.28170575287802246
Indiana,18107,Montgomery County,12659,4213,17198,8446,0.736073962088615,0.24497034538899873,0.4911036166996162
Indiana,18109,Morgan County,27512,7781,36159,19731,0.7608617494952847,0.21518847313255343,0.5456732763627313
Indiana,18111,Newton County,4942,1509,6591,3433,0.7498103474434835,0.22894856622667273,0.5208617812168108
Indiana,18113,Noble County,14195,4660,19190,9535,0.7397081813444503,0.24283480979676916,0.4968733715476811
Indiana,18115,Ohio County,2392,750,3164,1642,0.7560050568900126,0.2370417193426043,0.5189633375474083
Indiana,18117,Orange County,6432,2224,8832,4208,0.7282608695652174,0.25181159420289856,0.47644927536231885
Indiana,18119,Owen County,7286,2420,9904,4866,0.7356623586429726,0.24434571890145396,0.4913166397415186
Indiana,18121,Parke County,5398,1503,7011,3895,0.7699329624875196,0.21437740693196405,0.5555555555555556
Indiana,18123,Perry County,5345,3203,8722,2142,0.6128181609722541,0.3672322861728961,0.24558587479935795
Indiana,18125,Pike County,4692,1415,6220,3277,0.7543408360128617,0.227491961414791,0.5268488745980707
Indiana,18127,Porter County,45008,39746,86509,5262,0.5202695673282549,0.45944352610711026,0.060826041221144656
Indiana,18129,Posey County,9206,3811,13236,5395,0.695527349652463,0.2879268661226957,0.4076004835297673
Indiana,18131,Pulaski County,4246,1463,5806,2783,0.7313124354116431,0.2519807096107475,0.47933172580089567
Indiana,18133,Putnam County,12278,3946,16597,8332,0.7397722479966259,0.2377538109296861,0.5020184370669398
Indiana,18135,Randolph County,8312,2513,11070,5799,0.7508581752484191,0.22700993676603431,0.5238482384823848
Indiana,18137,Ripley County,11261,2774,14271,8487,0.7890827552378951,0.1943802116179665,0.5947025436199286
Indiana,18139,Rush County,6035,1754,7932,4281,0.7608421583459405,0.2211296016137166,0.5397125567322238
Indiana,18141,St. Joseph County,53164,59896,115238,-6732,0.4613408771412208,0.5197591072389316,-0.0584182300977108
Indiana,18143,Scott County,7328,2698,10161,4630,0.7211888593642358,0.2655250467473674,0.45566381261686845
Indiana,18145,Shelby County,14568,5023,19991,9545,0.7287279275674053,0.25126306838077134,0.477464859186634
Indiana,18147,Spencer County,7357,3213,10769,4144,0.6831646392422694,0.2983563933512861,0.38480824589098334
Indiana,18149,Starke County,7466,2650,10290,4816,0.7255587949465501,0.2575315840621963,0.4680272108843538
Indiana,18151,Steuben County,11327,4513,16162,6814,0.7008414800148497,0.2792352431629749,0.4216062368518748
Indiana,18153,Sullivan County,6691,2153,8994,4538,0.7439404047142539,0.2393818100956193,0.5045585946186346
Indiana,18155,Switzerland County,3133,964,4154,2169,0.7542128069330766,0.23206547905633124,0.5221473278767453
Indiana,18157,Tippecanoe County,34581,35017,71448,-436,0.48400235136042996,0.4901046915239055,-0.00610234016347555
Indiana,18159,Tipton County,6110,1834,8116,4276,0.7528339083292263,0.2259733859043864,0.5268605224248398
Indiana,18161,Union County,2688,736,3483,1952,0.7717484926787253,0.21131208728107953,0.5604364053976457
Indiana,18163,Vanderburgh County,41844,34415,77662,7429,0.538796322525817,0.44313821431330636,0.09565810821251064
Indiana,18165,Vermillion County,5184,2145,7481,3039,0.692955487234327,0.2867263734794814,0.4062291137548456
Indiana,18167,Vigo County,24545,18123,43594,6422,0.5630361976418773,0.4157223471119879,0.14731385052988938
Indiana,18169,Wabash County,10762,3494,14573,7268,0.73848898648185,0.23975845742125848,0.49873052906059157
Indiana,18171,Warren County,3401,974,4472,2427,0.7605098389982111,0.21779964221824688,0.5427101967799642
Indiana,18173,Warrick County,21326,11923,33829,9403,0.6304058647905643,0.3524490821484525,0.27795678264211177
Indiana,18175,Washington County,9114,2784,12139,6330,0.7508031963094159,0.22934343850399538,0.5214597578054205
Indiana,18177,Wayne County,17567,9524,27679,8043,0.6346688825463348,0.3440875754181871,0.2905813071281477
Indiana,18179,Wells County,10855,2928,14050,7927,0.7725978647686833,0.20839857651245552,0.5641992882562278
Indiana,18181,White County,7957,3032,11166,4925,0.7126097080422712,0.27153859931936236,0.44107110872290883
Indiana,18183,Whitley County,12862,4234,17556,8628,0.7326270221007063,0.24117110959216223,0.49145591250854403
Iowa,19001,Adair County,2917,1198,4177,1719,0.6983480967201341,0.28680871438831695,0.41153938233181714
Iowa,19003,Adams County,1530,590,2160,940,0.7083333333333334,0.27314814814814814,0.43518518518518523
Iowa,19005,Allamakee County,4735,2576,7422,2159,0.6379682026407977,0.3470762597682565,0.29089194287254116
Iowa,19007,Appanoose County,4512,1891,6516,2621,0.6924493554327809,0.2902087170042971,0.40224063842848373
Iowa,19009,Audubon County,2295,1071,3420,1224,0.6710526315789473,0.3131578947368421,0.35789473684210527
Iowa,19011,Benton County,9188,5160,14642,4028,0.6275099030187133,0.3524108728315804,0.27509903018713294
Iowa,19013,Black Hawk County,29640,35647,66593,-6007,0.4450918264682474,0.5352965026354122,-0.09020467616716477
Iowa,19015,Boone County,8695,6303,15340,2392,0.5668187744458931,0.4108865710560626,0.15593220338983055
Iowa,19017,Bremer County,8294,5958,14546,2336,0.5701911178330813,0.40959714010724596,0.16059397772583534
Iowa,19019,Buchanan County,6420,4169,10774,2251,0.5958789678856506,0.386950064971227,0.20892890291442362
Iowa,19021,Buena Vista County,5056,2961,8167,2095,0.6190767723766377,0.3625566303416187,0.256520142035019
Iowa,19023,Butler County,5542,2424,8098,3118,0.6843665102494443,0.2993331686836256,0.3850333415658187
Iowa,19025,Calhoun County,3689,1470,5258,2219,0.701597565614302,0.2795739825028528,0.42202358311144916
Iowa,19027,Carroll County,7737,3454,11335,4283,0.682576091751213,0.3047198941332157,0.3778561976179973
Iowa,19029,Cass County,4969,2201,7276,2768,0.6829301814183617,0.3025013743815283,0.3804288070368334
Iowa,19031,Cedar County,6161,4337,10703,1824,0.5756330000934318,0.4052134915444268,0.17041950854900495
Iowa,19033,Cerro Gordo County,12442,10941,23801,1501,0.5227511449098777,0.45968656779126926,0.06306457711860847
Iowa,19035,Cherokee County,4495,1936,6518,2559,0.6896287204664008,0.29702362687941086,0.3926050935869899
Iowa,19037,Chickasaw County,4308,2233,6631,2075,0.6496757653445936,0.336751621173277,0.3129241441713166
Iowa,19039,Clarke County,3144,1466,4670,1678,0.6732334047109207,0.3139186295503212,0.35931477516059956
Iowa,19041,Clay County,6137,2662,8969,3475,0.684245735310514,0.29680008919611994,0.3874456461143941
Iowa,19043,Clayton County,6106,3340,9594,2766,0.6364394413174901,0.34813425057327496,0.2883051907442151
Iowa,19045,Clinton County,13361,10812,24687,2549,0.541216024628347,0.43796330052254223,0.10325272410580472
Iowa,19047,Crawford County,4854,2220,7154,2634,0.6785015376013419,0.31031590718479174,0.36818563041655017
Iowa,19049,Dallas County,27987,26879,56022,1108,0.4995715968726572,0.4797936524936632,0.019777944378993995
Iowa,19051,Davis County,3032,1013,4102,2019,0.7391516333495856,0.24695270599707458,0.492198927352511
Iowa,19053,Decatur County,2615,1120,3804,1495,0.687434279705573,0.29442691903259727,0.39300736067297576
Iowa,19055,Delaware County,6666,3157,10003,3509,0.6664000799760071,0.31560531840447864,0.3507947615715285
Iowa,19057,Des Moines County,10592,8893,19956,1699,0.5307676889156143,0.44563038685107237,0.08513730206454195
Iowa,19059,Dickinson County,7438,3661,11244,3777,0.6615083600142299,0.32559587335467804,0.3359124866595518
Iowa,19061,Dubuque County,27214,25657,53926,1557,0.5046545265734526,0.47578162667358975,0.028872899899862803
Iowa,19063,Emmet County,3265,1520,4853,1745,0.6727797238821348,0.3132083247475788,0.359571399134556
Iowa,19065,Fayette County,6145,3835,10186,2310,0.6032790104064402,0.37649715295503633,0.22678185745140383
Iowa,19067,Floyd County,4732,3172,8032,1560,0.5891434262948207,0.3949203187250996,0.19422310756972117
Iowa,19069,Franklin County,3422,1626,5130,1796,0.6670565302144249,0.3169590643274854,0.3500974658869395
Iowa,19071,Fremont County,2711,1080,3857,1631,0.7028778843660877,0.2800103707544724,0.4228675136116153
Iowa,19073,Greene County,3223,1769,5057,1454,0.6373343879770615,0.3498121415859205,0.28752224639114105
Iowa,19075,Grundy County,4929,2206,7276,2723,0.6774326553051127,0.30318856514568443,0.3742440901594282
Iowa,19077,Guthrie County,4272,1985,6371,2287,0.6705383770208758,0.3115680426934547,0.3589703343274211
Iowa,19079,Hamilton County,4956,2843,7943,2113,0.6239456124889841,0.35792521717235304,0.266020395316631
Iowa,19081,Hancock County,4390,1683,6172,2707,0.7112767336357745,0.27268308489954635,0.43859364873622814
Iowa,19083,Hardin County,5850,2976,8989,2874,0.6507954166203137,0.33107130937812884,0.31972410724218486
Iowa,19085,Harrison County,5569,2440,8155,3129,0.6828939301042305,0.299202942979767,0.3836909871244635
Iowa,19087,Henry County,6507,3275,9982,3232,0.6518733720697255,0.32809056301342415,0.32378280905630136
Iowa,19089,Howard County,3127,1772,4958,1355,0.6306978620411456,0.3574021782977007,0.27329568374344493
Iowa,19091,Humboldt County,3819,1442,5327,2377,0.7169138351792754,0.2706964520367937,0.4462173831424817
Iowa,19093,Ida County,2880,917,3849,1963,0.7482462977396727,0.23824369966224992,0.5100025980774228
Iowa,19095,Iowa County,6009,3547,9742,2462,0.6168137959351263,0.364093615274071,0.2527201806610553
Iowa,19097,Jackson County,6940,4029,11135,2911,0.6232599910193085,0.3618320610687023,0.2614279299506062
Iowa,19099,Jasper County,12084,7737,20184,4347,0.598692033293698,0.38332342449464923,0.2153686087990488
Iowa,19101,Jefferson County,4443,4319,8959,124,0.4959258845853332,0.4820850541355062,0.013840830449827035
Iowa,19103,Johnson County,22925,59177,83851,-36252,0.2734016290801541,0.7057399434711572,-0.4323383143910031
Iowa,19105,Jones County,6572,4213,10989,2359,0.598052598052598,0.3833833833833834,0.21466921466921463
Iowa,19107,Keokuk County,3797,1414,5303,2383,0.7160098057703187,0.26664152366584953,0.44936828210446916
Iowa,19109,Kossuth County,6275,2696,9090,3579,0.6903190319031903,0.29658965896589656,0.39372937293729376
Iowa,19111,Lee County,9773,6541,16734,3232,0.5840205569499223,0.39088084140074103,0.19313971554918125
Iowa,19113,Linn County,53364,70874,127458,-17510,0.4186790942898837,0.5560576817461438,-0.13737858745626008
Iowa,19115,Louisa County,3500,1726,5332,1774,0.6564141035258815,0.3237059264816204,0.3327081770442611
Iowa,19117,Lucas County,3287,1284,4630,2003,0.7099352051835853,0.27732181425485963,0.4326133909287257
Iowa,19119,Lyon County,5707,1067,6863,4640,0.83156054203701,0.15547136820632376,0.6760891738306862
Iowa,19121,Madison County,6507,3134,9824,3373,0.6623574918566775,0.31901465798045603,0.34334283387622144
Iowa,19123,Mahaska County,8297,2894,11404,5403,0.7275517362329007,0.25377060680462993,0.4737811294282708
Iowa,19125,Marion County,12663,6178,19232,6485,0.6584338602329451,0.32123544093178036,0.3371984193011648
Iowa,19127,Marshall County,9571,8176,18136,1395,0.5277348919276577,0.45081605646228495,0.0769188354653727
Iowa,19129,Mills County,5585,2508,8268,3077,0.6754958877600387,0.3033381712626996,0.3721577164973391
Iowa,19131,Mitchell County,3677,2053,5822,1624,0.6315699072483683,0.3526279628993473,0.278941944349021
Iowa,19133,Monona County,3248,1407,4728,1841,0.6869712351945855,0.29758883248730966,0.3893824027072758
Iowa,19135,Monroe County,2975,1078,4088,1897,0.7277397260273972,0.2636986301369863,0.4640410958904109
Iowa,19137,Montgomery County,3659,1583,5327,2076,0.6868781678242913,0.2971653838933734,0.38971278393091796
Iowa,19139,Muscatine County,10823,9372,20671,1451,0.5235837646944995,0.453388805573025,0.0701949591214745
Iowa,19141,O'Brien County,5861,1569,7551,4292,0.776188584293471,0.2077870480731029,0.5684015362203682
Iowa,19143,Osceola County,2690,601,3328,2089,0.8082932692307693,0.18058894230769232,0.627704326923077
Iowa,19145,Page County,5319,2086,7528,3233,0.7065621679064825,0.2770988310308183,0.42946333687566424
Iowa,19147,Palo Alto County,3370,1519,4958,1851,0.6797095603065753,0.3063735377168213,0.37333602258975396
Iowa,19149,Plymouth County,10492,3494,14188,6998,0.7394981674654638,0.24626444882999718,0.4932337186354666
Iowa,19151,Pocahontas County,2826,933,3823,1893,0.7392100444676956,0.24404917603975934,0.4951608684279362
Iowa,19153,Polk County,106800,146250,258755,-39450,0.41274564742710285,0.565206469440204,-0.15246082201310118
Iowa,19155,Pottawattamie County,26247,18575,45744,7672,0.5737801678908709,0.40606418328086746,0.16771598461000348
Iowa,19157,Poweshiek County,5657,4306,10140,1351,0.5578895463510848,0.42465483234714,0.13323471400394477
Iowa,19159,Ringgold County,1968,709,2714,1259,0.7251289609432572,0.261238025055269,0.4638909358879882
Iowa,19161,Sac County,4061,1389,5535,2672,0.7336946702800361,0.25094850948509484,0.48274616079494126
Iowa,19163,Scott County,43683,46926,92599,-3243,0.47174375533213103,0.5067657318113586,-0.03502197647922761
Iowa,19165,Shelby County,4697,1959,6795,2738,0.691243561442237,0.2883002207505519,0.4029433406916851
Iowa,19167,Sioux County,15680,3019,19051,12661,0.8230539079313421,0.15846937168652564,0.6645845362448165
Iowa,19169,Story County,20340,29175,51038,-8835,0.3985265880324464,0.5716329009757436,-0.1731063129432972
Iowa,19171,Tama County,5303,3577,9048,1726,0.5860963748894783,0.3953359858532272,0.1907603890362511
Iowa,19173,Taylor County,2463,746,3249,1717,0.7580794090489381,0.2296091104955371,0.528470298553401
Iowa,19175,Union County,4010,2061,6185,1949,0.6483427647534358,0.3332255456750202,0.31511721907841556
Iowa,19177,Van Buren County,2859,875,3791,1984,0.7541545766288579,0.2308098127143234,0.5233447639145344
Iowa,19179,Wapello County,9516,5821,15633,3695,0.6087123392822875,0.3723533550821979,0.2363589842000896
Iowa,19181,Warren County,17782,12574,31039,5208,0.5728921679177809,0.4051032571925642,0.16778891072521668
Iowa,19183,Washington County,6971,4561,11765,2410,0.5925201869953252,0.38767530811729706,0.2048448788780281
Iowa,19185,Wayne County,2338,727,3109,1611,0.752010292698617,0.23383724670311998,0.518173045995497
Iowa,19187,Webster County,10938,6613,17822,4325,0.6137358321176074,0.3710582426214791,0.24267758949612833
Iowa,19189,Winnebago County,3707,2135,5970,1572,0.6209380234505862,0.3576214405360134,0.2633165829145728
Iowa,19191,Winneshiek County,6235,5617,12064,618,0.5168269230769231,0.4656001326259947,0.05122679045092843
Iowa,19193,Woodbury County,25736,18704,45362,7032,0.5673471187337419,0.4123274987875314,0.1550196199462105
Iowa,19195,Worth County,2738,1596,4418,1142,0.6197374377546401,0.3612494341330919,0.25848800362154817
Iowa,19197,Wright County,4136,1996,6254,2140,0.6613367444835305,0.31915574032619126,0.34218100415733926
Kansas,20001,Allen County,4155,1559,5842,2596,0.7112290311537145,0.2668606641561109,0.44436836699760357
Kansas,20003,Anderson County,2874,765,3720,2109,0.7725806451612903,0.2056451612903226,0.5669354838709677
Kansas,20005,Atchison County,4826,2314,7312,2512,0.6600109409190372,0.3164660831509847,0.34354485776805255
Kansas,20007,Barber County,1992,284,2313,1708,0.8612191958495461,0.12278426286208387,0.7384349329874622
Kansas,20009,Barton County,8480,2302,10961,6178,0.7736520390475322,0.21001733418483715,0.5636347048626951
Kansas,20011,Bourbon County,4910,1505,6550,3405,0.749618320610687,0.2297709923664122,0.5198473282442748
Kansas,20013,Brown County,3206,1088,4396,2118,0.7292993630573248,0.24749772520473157,0.4818016378525932
Kansas,20015,Butler County,22250,9003,31946,13247,0.6964878232016528,0.28181932010267324,0.41466850309897957
Kansas,20017,Chase County,1114,341,1478,773,0.7537212449255751,0.2307171853856563,0.5230040595399188
Kansas,20019,Chautauqua County,1397,212,1634,1185,0.8549571603427173,0.12974296205630356,0.7252141982864138
Kansas,20021,Cherokee County,6622,2163,8945,4459,0.7403018446059251,0.24181106763555058,0.49849077697037447
Kansas,20023,Cheyenne County,1158,220,1400,938,0.8271428571428572,0.15714285714285714,0.67
Kansas,20025,Clark County,885,143,1048,742,0.8444656488549618,0.1364503816793893,0.7080152671755725
Kansas,20027,Clay County,3129,883,4134,2246,0.7568940493468795,0.21359458151910982,0.5432994678277697
Kansas,20029,Cloud County,3182,893,4174,2289,0.7623382846190704,0.21394345951126018,0.5483948251078102
Kansas,20031,Coffey County,3407,928,4448,2479,0.7659622302158273,0.20863309352517986,0.5573291366906474
Kansas,20033,Comanche County,745,126,904,619,0.8241150442477876,0.13938053097345132,0.6847345132743363
Kansas,20035,Cowley County,9442,4171,13911,5271,0.6787434404428151,0.29983466321615987,0.3789087772266552
Kansas,20037,Crawford County,10045,6179,16718,3866,0.6008493838975955,0.3696016269888743,0.23124775690872118
Kansas,20039,Decatur County,1232,208,1458,1024,0.8449931412894376,0.14266117969821673,0.7023319615912209
Kansas,20041,Dickinson County,7045,2040,9246,5005,0.7619511139952412,0.22063595068137573,0.5413151633138654
Kansas,20043,Doniphan County,2949,678,3674,2271,0.8026673924877518,0.18454001088731628,0.6181273816004355
Kansas,20045,Douglas County,16737,39436,57540,-22699,0.2908759124087591,0.6853667014250956,-0.3944907890163365
Kansas,20047,Edwards County,1127,267,1413,860,0.7975937721160651,0.18895966029723993,0.6086341118188252
Kansas,20049,Elk County,1130,191,1347,939,0.8389012620638456,0.14179658500371195,0.6971046770601337
Kansas,20051,Ellis County,9569,3633,13501,5936,0.7087623139026739,0.2690911784312273,0.43967113547144654
Kansas,20053,Ellsworth County,2106,646,2806,1460,0.7505345687811832,0.23022095509622237,0.5203136136849609
Kansas,20055,Finney County,7079,4155,11466,2924,0.6173905459619745,0.36237571951857667,0.25501482644339785
Kansas,20057,Ford County,5763,2926,8850,2837,0.651186440677966,0.3306214689265537,0.32056497175141235
Kansas,20059,Franklin County,8326,3623,12247,4703,0.6798399608067281,0.29582754960398466,0.3840124112027435
Kansas,20061,Geary County,5193,3825,9311,1368,0.5577274191816132,0.4108044248738052,0.14692299430780797
Kansas,20063,Gove County,1256,163,1433,1093,0.8764829030006979,0.1137473831123517,0.7627355198883462
Kansas,20065,Graham County,1052,222,1302,830,0.8079877112135176,0.17050691244239632,0.6374807987711213
Kansas,20067,Grant County,1910,497,2452,1413,0.7789559543230016,0.20269168026101142,0.5762642740619901
Kansas,20069,Gray County,1871,337,2240,1534,0.8352678571428571,0.15044642857142856,0.6848214285714286
Kansas,20071,Greeley County,537,77,629,460,0.8537360890302067,0.12241653418124006,0.7313195548489666
Kansas,20073,Greenwood County,2404,562,3030,1842,0.7933993399339934,0.18547854785478549,0.6079207920792079
Kansas,20075,Hamilton County,684,134,837,550,0.8172043010752689,0.16009557945041816,0.6571087216248507
Kansas,20077,Harper County,2128,453,2626,1675,0.8103579588728104,0.1725057121096725,0.6378522467631379
Kansas,20079,Harvey County,10015,6652,17034,3363,0.58794176353176,0.39051309146413055,0.19742867206762943
Kansas,20081,Haskell County,1103,261,1383,842,0.7975415762834418,0.18872017353579176,0.6088214027476501
Kansas,20083,Hodgeman County,866,151,1033,715,0.8383349467570184,0.14617618586640851,0.6921587608906099
Kansas,20085,Jackson County,4435,1852,6468,2583,0.6856833642547928,0.28633271490414347,0.39935064935064934
Kansas,20087,Jefferson County,6193,3106,9581,3087,0.6463834672789897,0.32418327940716,0.32220018787182964
Kansas,20089,Jewell County,1369,211,1608,1158,0.8513681592039801,0.13121890547263682,0.7201492537313433
Kansas,20091,Johnson County,155631,184259,349386,-28628,0.4454414315399014,0.5273794599669134,-0.08193802842701198
Kansas,20093,Kearny County,1134,255,1413,879,0.802547770700637,0.18046709129511676,0.6220806794055203
Kansas,20095,Kingman County,3102,745,3929,2357,0.7895138712140494,0.18961567828964113,0.5998981929244083
Kansas,20097,Kiowa County,957,153,1139,804,0.8402107111501317,0.13432835820895522,0.7058823529411764
Kansas,20099,Labette County,5639,2607,8414,3032,0.6701925362491087,0.3098407416211077,0.360351794628001
Kansas,20101,Lane County,757,114,888,643,0.8524774774774775,0.12837837837837837,0.7240990990990991
Kansas,20103,Leavenworth County,21378,13753,36115,7625,0.591942406202409,0.3808112972449121,0.21113110895749693
Kansas,20105,Lincoln County,1273,266,1570,1007,0.810828025477707,0.16942675159235668,0.6414012738853504
Kansas,20107,Linn County,3940,863,4903,3077,0.8035896389965327,0.176014684886804,0.6275749541097286
Kansas,20109,Logan County,1231,185,1437,1046,0.8566457898399443,0.12874043145441894,0.7279053583855254
Kansas,20111,Lyon County,7381,5878,13622,1503,0.5418440757598003,0.43150785494053734,0.11033622081926298
Kansas,20113,McPherson County,9562,3977,13868,5585,0.6895010095183155,0.2867753100663398,0.4027256994519757
Kansas,20115,Marion County,4377,1463,5969,2914,0.7332886580666779,0.2450996816887251,0.4881889763779528
Kansas,20117,Marshall County,3662,1239,5023,2423,0.7290463866215409,0.24666533943858251,0.4823810471829584
Kansas,20119,Meade County,1508,261,1807,1247,0.8345323741007195,0.1444382955174322,0.6900940785832872
Kansas,20121,Miami County,12116,5133,17624,6983,0.6874716295960055,0.29125056740807986,0.39622106218792563
Kansas,20123,Mitchell County,2454,547,3039,1907,0.807502467917078,0.17999341888779205,0.627509049029286
Kansas,20125,Montgomery County,9768,3147,13177,6621,0.7412916445321394,0.2388252257721788,0.5024664187599606
Kansas,20127,Morris County,2085,721,2849,1364,0.7318357318357318,0.25307125307125306,0.47876447876447875
Kansas,20129,Morton County,1004,147,1163,857,0.8632846087704213,0.12639724849527084,0.7368873602751504
Kansas,20131,Nemaha County,4612,920,5625,3692,0.8199111111111111,0.16355555555555557,0.6563555555555556
Kansas,20133,Neosho County,4795,1727,6629,3068,0.723336853220697,0.26052194901191733,0.46281490420877963
Kansas,20135,Ness County,1315,147,1487,1168,0.8843308675184937,0.0988567585743107,0.785474108944183
Kansas,20137,Norton County,1977,361,2390,1616,0.8271966527196652,0.15104602510460252,0.6761506276150627
Kansas,20139,Osage County,5591,2099,7893,3492,0.7083491701507665,0.2659318383377676,0.44241733181299886
Kansas,20141,Osborne County,1590,275,1899,1315,0.8372827804107424,0.14481305950500264,0.6924697209057398
Kansas,20143,Ottawa County,2581,504,3159,2077,0.8170307059195948,0.15954415954415954,0.6574865463754352
Kansas,20145,Pawnee County,2028,635,2712,1393,0.7477876106194691,0.23414454277286137,0.5136430678466077
Kansas,20147,Phillips County,2388,318,2752,2070,0.8677325581395349,0.11555232558139535,0.7521802325581395
Kansas,20149,Pottawatomie County,9247,3257,12815,5990,0.7215762777994538,0.2541552867733125,0.46742099102614126
Kansas,20151,Pratt County,3087,924,4107,2163,0.7516435354273192,0.22498173849525202,0.5266617969320672
Kansas,20153,Rawlins County,1253,214,1496,1039,0.8375668449197861,0.14304812834224598,0.69451871657754
Kansas,20155,Reno County,17948,8602,27245,9346,0.6587630757937236,0.3157276564507249,0.3430354193429987
Kansas,20157,Republic County,2172,420,2643,1752,0.8217934165720772,0.15891032917139614,0.662883087400681
Kansas,20159,Rice County,3187,953,4230,2234,0.7534278959810875,0.22529550827423167,0.5281323877068558
Kansas,20161,Riley County,11174,11940,23855,-766,0.4684133305386711,0.5005239991616014,-0.03211066862293027
Kansas,20163,Rooks County,2294,332,2661,1962,0.8620819240886884,0.1247651258925216,0.7373167981961668
Kansas,20165,Rush County,1425,291,1748,1134,0.8152173913043478,0.16647597254004576,0.648741418764302
Kansas,20167,Russell County,2765,591,3429,2174,0.8063575386410032,0.17235345581802275,0.6340040828229805
Kansas,20169,Saline County,15313,8022,23911,7291,0.640416544686546,0.33549412404332735,0.3049224206432186
Kansas,20171,Scott County,1991,290,2322,1701,0.8574504737295435,0.12489233419465978,0.7325581395348837
Kansas,20173,Sedgwick County,117653,90820,213552,26833,0.550933730426313,0.42528283509402864,0.12565089533228435
Kansas,20175,Seward County,3285,1736,5099,1549,0.6442439694057658,0.34045891351245344,0.30378505589331234
Kansas,20177,Shawnee County,40443,43015,86122,-2572,0.4696012633241216,0.49946587399270803,-0.029864610668586422
Kansas,20179,Sheridan County,1237,144,1397,1093,0.8854688618468146,0.10307802433786686,0.7823908375089478
Kansas,20181,Sherman County,2222,386,2673,1836,0.831275720164609,0.1444070332959222,0.6868686868686869
Kansas,20183,Smith County,1734,328,2092,1406,0.8288718929254302,0.15678776290630975,0.6720841300191205
Kansas,20185,Stafford County,1631,355,2017,1276,0.8086266732771443,0.1760039662865642,0.6326227069905801
Kansas,20187,Stanton County,607,147,767,460,0.7913950456323338,0.19165580182529335,0.5997392438070404
Kansas,20189,Stevens County,1731,233,1997,1498,0.8668002003004507,0.11667501251877817,0.7501251877816725
Kansas,20191,Sumner County,7998,2551,10779,5447,0.7419983300862789,0.23666388347713146,0.5053344466091474
Kansas,20193,Thomas County,3106,622,3794,2484,0.8186610437532946,0.1639430680021086,0.6547179757511861
Kansas,20195,Trego County,1341,238,1603,1103,0.8365564566437929,0.14847161572052403,0.6880848409232688
Kansas,20197,Wabaunsee County,2813,956,3861,1857,0.7285677285677286,0.2476042476042476,0.48096348096348096
Kansas,20199,Wallace County,762,44,817,718,0.9326805385556916,0.05385556915544676,0.8788249694002448
Kansas,20201,Washington County,2332,467,2843,1865,0.8202602884277173,0.1642631023566655,0.6559971860710517
Kansas,20203,Wichita County,803,147,961,656,0.8355879292403746,0.1529656607700312,0.6826222684703434
Kansas,20205,Wilson County,3111,711,3899,2400,0.7978968966401642,0.1823544498589382,0.6155424467812259
Kansas,20207,Woodson County,1189,283,1495,906,0.7953177257525084,0.18929765886287625,0.6060200668896321
Kansas,20209,Wyandotte County,18512,35566,55107,-17054,0.33592828497287097,0.6453989511314352,-0.3094706661585642
Kentucky,21001,Adair County,7276,1392,8768,5884,0.8298357664233577,0.15875912408759124,0.6710766423357664
Kentucky,21003,Allen County,7587,1642,9364,5945,0.8102306706535668,0.17535241349850492,0.6348782571550619
Kentucky,21005,Anderson County,9661,3348,13254,6313,0.7289120265580202,0.2526029877772748,0.47630903878074543
Kentucky,21007,Ballard County,3356,825,4225,2531,0.7943195266272189,0.1952662721893491,0.5990532544378698
Kentucky,21009,Barren County,14654,5127,20064,9527,0.7303628389154705,0.2555322966507177,0.4748305422647528
Kentucky,21011,Bath County,3986,1573,5627,2413,0.7083703572063267,0.27954505064865826,0.42882530655766843
Kentucky,21013,Bell County,8140,1789,10044,6351,0.8104340900039825,0.1781162883313421,0.6323178016726404
Kentucky,21015,Boone County,44814,20901,66998,23913,0.668885638377265,0.3119645362548136,0.35692110212245143
Kentucky,21017,Bourbon County,6190,3296,9648,2894,0.6415837479270315,0.3416252072968491,0.29995854063018246
Kentucky,21019,Boyd County,14295,7083,21751,7212,0.657211162705163,0.325640200450554,0.331570962254609
Kentucky,21021,Boyle County,8872,5298,14478,3574,0.6127918220748723,0.3659345213427269,0.24685730073214535
Kentucky,21023,Bracken County,3398,800,4246,2598,0.8002826189354687,0.18841262364578426,0.6118699952896844
Kentucky,21025,Breathitt County,4265,1301,5661,2964,0.7534004592828122,0.2298180533474651,0.5235824059353471
Kentucky,21027,Breckinridge County,7701,2350,10201,5351,0.7549259876482698,0.2303695716106264,0.5245564160376434
Kentucky,21029,Bullitt County,30708,10552,41998,20156,0.7311776751273871,0.25125005952664414,0.47992761560074293
Kentucky,21031,Butler County,4960,1079,6125,3881,0.809795918367347,0.17616326530612245,0.6336326530612245
Kentucky,21033,Caldwell County,4906,1433,6434,3473,0.7625116568231272,0.22272303388249923,0.5397886229406279
Kentucky,21035,Calloway County,11352,5797,17457,5555,0.6502835538752363,0.3320730938878387,0.3182104599873976
Kentucky,21037,Campbell County,28482,19374,48878,9108,0.5827161504153198,0.3963746470804861,0.18634150333483368
Kentucky,21039,Carlisle County,2159,463,2638,1696,0.8184230477634572,0.1755117513267627,0.6429112964366945
Kentucky,21041,Carroll County,2954,1116,4136,1838,0.7142166344294004,0.269825918762089,0.4443907156673114
Kentucky,21043,Carter County,8775,2642,11586,6133,0.7573795960642155,0.22803383393751078,0.5293457621267047
Kentucky,21045,Casey County,6179,918,7171,5261,0.8616650397434109,0.12801561846325477,0.7336494212801561
Kentucky,21047,Christian County,15080,8296,23863,6784,0.6319406612747769,0.34765117545991703,0.28428948581485985
Kentucky,21049,Clark County,11811,6004,18139,5807,0.6511384310050168,0.3309995038315232,0.32013892717349357
Kentucky,21051,Clay County,6677,831,7591,5846,0.8795942563562114,0.109471742853379,0.7701225135028323
Kentucky,21053,Clinton County,4280,603,4932,3677,0.8678021086780211,0.12226277372262774,0.7455393349553934
Kentucky,21055,Crittenden County,3451,731,4242,2720,0.8135313531353136,0.17232437529467232,0.6412069778406413
Kentucky,21057,Cumberland County,2769,508,3309,2261,0.8368087035358114,0.1535207011181626,0.6832880024176488
Kentucky,21059,Daviess County,31025,17286,49287,13739,0.629476332501471,0.3507212855316818,0.27875504696978914
Kentucky,21061,Edmonson County,4828,1227,6132,3601,0.7873450750163079,0.20009784735812133,0.5872472276581866
Kentucky,21063,Elliott County,2246,712,2995,1534,0.7499165275459099,0.23772954924874792,0.512186978297162
Kentucky,21065,Estill County,5100,1355,6540,3745,0.7798165137614679,0.20718654434250763,0.5726299694189603
Kentucky,21067,Fayette County,58860,90600,152912,-31740,0.38492727843465524,0.5924976457047191,-0.20757036727006384
Kentucky,21069,Fleming County,5534,1474,7068,4060,0.7829654782116582,0.20854555744199207,0.5744199207696661
Kentucky,21071,Floyd County,12250,3884,16353,8366,0.7490980248272489,0.23750993701461506,0.5115880878126338
Kentucky,21073,Franklin County,12900,12652,26072,248,0.49478367597422523,0.48527155569193003,0.0095121202822952
Kentucky,21075,Fulton County,1606,794,2426,812,0.6619950535861501,0.32728771640560594,0.33470733718054413
Kentucky,21077,Gallatin County,2955,822,3849,2133,0.7677318784099766,0.21356196414653156,0.5541699142634451
Kentucky,21079,Garrard County,6754,1830,8706,4924,0.7757868136917069,0.2101998621640248,0.5655869515276821
Kentucky,21081,Grant County,8725,2205,11108,6520,0.7854699315808427,0.1985055815628376,0.5869643500180051
Kentucky,21083,Graves County,13206,3560,17019,9646,0.7759562841530054,0.2091779775544979,0.5667783065985075
Kentucky,21085,Grayson County,9453,2400,11985,7053,0.7887359198998748,0.2002503128911139,0.588485607008761
Kentucky,21087,Green County,4838,920,5812,3918,0.8324156916724019,0.1582931865106676,0.6741225051617343
Kentucky,21089,Greenup County,13064,4873,18176,8191,0.71875,0.2681007922535211,0.4506492077464789
Kentucky,21091,Hancock County,3145,1351,4587,1794,0.6856333115325921,0.2945280139524744,0.3911052975801177
Kentucky,21093,Hardin County,29832,18101,48941,11731,0.6095502748207025,0.3698534970678981,0.23969677775280435
Kentucky,21095,Harlan County,9367,1494,10971,7873,0.8537963722541245,0.1361771944216571,0.7176191778324674
Kentucky,21097,Harrison County,6334,2400,8859,3934,0.7149791172818603,0.2709109380291229,0.44406817925273734
Kentucky,21099,Hart County,6345,1908,8370,4437,0.7580645161290323,0.22795698924731184,0.5301075268817204
Kentucky,21101,Henderson County,12730,7639,20697,5091,0.6150649852635648,0.3690873073392279,0.2459776779243369
Kentucky,21103,Henry County,5843,2142,8110,3701,0.7204685573366214,0.26411837237977803,0.4563501849568434
Kentucky,21105,Hickman County,1714,458,2199,1256,0.7794452023647113,0.20827648931332424,0.5711687130513871
Kentucky,21107,Hopkins County,15757,5439,21512,10318,0.7324748977314987,0.2528356266269989,0.4796392711044998
Kentucky,21109,Jackson County,5453,605,6113,4848,0.8920333715033535,0.09896940945525928,0.7930639620480942
Kentucky,21111,Jefferson County,150646,228358,386629,-77712,0.3896396804171441,0.590638570826296,-0.20099889040915192
Kentucky,21113,Jessamine County,17096,8567,26280,8529,0.6505327245053273,0.32598934550989345,0.32454337899543384
Kentucky,21115,Johnson County,8450,1608,10192,6842,0.8290816326530612,0.1577708006279435,0.6713108320251178
Kentucky,21117,Kenton County,48129,32271,82198,15858,0.5855251952602253,0.39260079320664737,0.19292440205357791
Kentucky,21119,Knott County,4780,1412,6252,3368,0.7645553422904671,0.22584772872680742,0.5387076135636597
Kentucky,21121,Knox County,11012,2114,13273,8898,0.8296541851879756,0.159270699917125,0.6703834852708506
Kentucky,21123,Larue County,5685,1504,7301,4181,0.7786604574715792,0.20599917819476785,0.5726612792768113
Kentucky,21125,Laurel County,23237,4475,28111,18762,0.8266159154779268,0.15919035253103767,0.6674255629468892
Kentucky,21127,Lawrence County,5633,1238,6955,4395,0.809920920201294,0.17800143781452193,0.6319194823867721
Kentucky,21129,Lee County,2273,481,2801,1792,0.8114958943234559,0.1717243841485184,0.6397715101749375
Kentucky,21131,Leslie County,4321,446,4813,3875,0.8977768543527945,0.09266569707043425,0.8051111572823603
Kentucky,21133,Letcher County,7226,1799,9135,5427,0.7910235358511221,0.19693486590038314,0.594088669950739
Kentucky,21135,Lewis County,4986,823,5883,4163,0.847526772055074,0.1398946115927248,0.7076321604623492
Kentucky,21137,Lincoln County,8489,2254,10914,6235,0.777808319589518,0.2065237309877222,0.5712845886017959
Kentucky,21139,Livingston County,4010,939,5004,3071,0.8013589128697043,0.18764988009592326,0.6137090327737811
Kentucky,21141,Logan County,9067,3094,12350,5973,0.73417004048583,0.2505263157894737,0.4836437246963563
Kentucky,21143,Lyon County,3100,1092,4228,2008,0.7332071901608326,0.2582781456953642,0.47492904446546835
Kentucky,21145,McCracken County,21820,11195,33549,10625,0.6503919639929655,0.3336910191063817,0.3167009448865838
Kentucky,21147,McCreary County,5664,725,6438,4939,0.8797763280521901,0.11261261261261261,0.7671637154395775
Kentucky,21149,McLean County,3633,1074,4782,2559,0.759723964868256,0.2245922208281054,0.5351317440401506
Kentucky,21151,Madison County,27356,15581,43957,11775,0.6223354642036536,0.3544600404941193,0.2678754237095343
Kentucky,21153,Magoffin County,4174,1214,5447,2960,0.7662933724986231,0.22287497705158804,0.5434183954470351
Kentucky,21155,Marion County,6113,2722,8928,3391,0.6846998207885304,0.3048835125448029,0.37981630824372753
Kentucky,21157,Marshall County,13297,4071,17603,9226,0.7553826052377436,0.23126739760268136,0.5241152076350623
Kentucky,21159,Martin County,3496,403,3936,3093,0.8882113821138211,0.10238821138211382,0.7858231707317073
Kentucky,21161,Mason County,5477,2362,7958,3115,0.6882382508167881,0.29680824327720534,0.3914300075395828
Kentucky,21163,Meade County,10185,3632,14113,6553,0.7216750513710763,0.25735137816197834,0.464323673209098
Kentucky,21165,Menifee County,2311,750,3102,1561,0.745003223726628,0.24177949709864605,0.503223726627982
Kentucky,21167,Mercer County,8506,3033,11735,5473,0.7248402215594376,0.2584576054537708,0.46638261610566684
Kentucky,21169,Metcalfe County,3959,975,5012,2984,0.789904229848364,0.19453312051077415,0.5953711093375897
Kentucky,21171,Monroe County,4628,657,5330,3971,0.8682926829268293,0.12326454033771107,0.7450281425891182
Kentucky,21173,Montgomery County,8993,3630,12842,5363,0.7002803301666407,0.2826662513627161,0.4176140788039246
Kentucky,21175,Morgan County,4301,1175,5544,3126,0.7757936507936508,0.21194083694083693,0.5638528138528138
Kentucky,21177,Muhlenberg County,10497,3545,14235,6952,0.7374077976817703,0.24903407095187918,0.48837372672989116
Kentucky,21179,Nelson County,15703,7188,23256,8515,0.6752235982112144,0.3090815273477812,0.36614207086343314
Kentucky,21181,Nicholas County,2408,955,3396,1453,0.7090694935217904,0.28121319199057715,0.42785630153121323
Kentucky,21183,Ohio County,8582,2404,11129,6178,0.7711384670680205,0.2160122203252763,0.5551262467427441
Kentucky,21185,Oldham County,22654,14505,37976,8149,0.5965346534653465,0.3819517590056878,0.21458289445965872
Kentucky,21187,Owen County,4292,1098,5458,3194,0.786368633198974,0.20117259069256138,0.5851960425064127
Kentucky,21189,Owsley County,1671,216,1896,1455,0.8813291139240507,0.11392405063291139,0.7674050632911393
Kentucky,21191,Pendleton County,5515,1322,6925,4193,0.7963898916967509,0.19090252707581226,0.6054873646209387
Kentucky,21193,Perry County,8129,2356,10626,5773,0.7650103519668737,0.2217203086768304,0.5432900432900434
Kentucky,21195,Pike County,20284,4866,25395,15418,0.7987399094309904,0.19161252215002952,0.6071273872809608
Kentucky,21197,Powell County,4041,1367,5505,2674,0.7340599455040872,0.2483197093551317,0.48574023614895545
Kentucky,21199,Pulaski County,25442,5666,31557,19776,0.8062236587761827,0.17954811927623032,0.6266755394999524
Kentucky,21201,Robertson County,884,253,1146,631,0.7713787085514834,0.22076788830715532,0.5506108202443281
Kentucky,21203,Rockcastle County,6577,1134,7784,5443,0.8449383350462487,0.14568345323741008,0.6992548818088387
Kentucky,21205,Rowan County,5994,3880,10065,2114,0.5955290611028315,0.3854942871336314,0.21003477396920017
Kentucky,21207,Russell County,7519,1331,8955,6188,0.83964265773311,0.1486320491345617,0.6910106085985482
Kentucky,21209,Scott County,17767,10567,28969,7200,0.6133107804894887,0.36476923607994755,0.24854154440954118
Kentucky,21211,Shelby County,15055,8077,23550,6978,0.6392781316348195,0.3429723991507431,0.2963057324840764
Kentucky,21213,Simpson County,5888,2681,8732,3207,0.674301420064132,0.3070316078790655,0.36726981218506644
Kentucky,21215,Spencer County,8737,2530,11433,6207,0.7641913758418613,0.22128925041546402,0.5429021254263973
Kentucky,21217,Taylor County,9376,2963,12517,6413,0.7490612766637373,0.2367180634337301,0.5123432132300072
Kentucky,21219,Todd County,4062,1205,5363,2857,0.7574118963266828,0.22468767480887564,0.5327242215178072
Kentucky,21221,Trigg County,5487,1791,7376,3696,0.7438991323210412,0.24281453362255964,0.5010845986984815
Kentucky,21223,Trimble County,3227,1012,4320,2215,0.7469907407407408,0.23425925925925925,0.5127314814814815
Kentucky,21225,Union County,4965,1529,6577,3436,0.7549034514216209,0.23247681313668847,0.5224266382849324
Kentucky,21227,Warren County,31791,22479,55401,9312,0.5738344073211675,0.4057507987220447,0.1680836085991228
Kentucky,21229,Washington County,4482,1644,6225,2838,0.72,0.2640963855421687,0.4559036144578313
Kentucky,21231,Wayne County,7430,1700,9240,5730,0.8041125541125541,0.18398268398268397,0.6201298701298701
Kentucky,21233,Webster County,4506,1412,5993,3094,0.7518771900550643,0.23560820957784082,0.5162689804772235
Kentucky,21235,Whitley County,12567,2552,15356,10015,0.8183771815576973,0.166189111747851,0.6521880698098463
Kentucky,21237,Wolfe County,2097,839,2979,1258,0.7039274924471299,0.28163813360187984,0.4222893588452501
Kentucky,21239,Woodford County,8362,6530,15211,1832,0.5497337453158898,0.4292945894418513,0.12043915587403853
Louisiana,22001,Acadia Parish,22596,5443,28425,17153,0.794934036939314,0.19148636763412488,0.6034476693051891
Louisiana,22003,Allen Parish,7574,2108,9810,5466,0.7720693170234455,0.2148827726809378,0.5571865443425077
Louisiana,22005,Ascension Parish,40687,20399,62325,20288,0.6528198957079824,0.32730044123545926,0.3255194544725231
Louisiana,22007,Assumption Parish,7271,3833,11235,3438,0.6471740097908322,0.34116599910992434,0.3060080106809078
Louisiana,22009,Avoyelles Parish,12028,4979,17292,7049,0.6955817719176498,0.28793661808928983,0.40764515382836
Louisiana,22011,Beauregard Parish,13575,2542,16357,11033,0.8299199119642966,0.1554074708076053,0.6745124411566913
Louisiana,22013,Bienville Parish,3891,3067,7050,824,0.5519148936170213,0.4350354609929078,0.11687943262411349
Louisiana,22015,Bossier Parish,38074,15662,54655,22412,0.6966242795718598,0.28656115634434176,0.41006312322751803
Louisiana,22017,Caddo Parish,48021,55110,104912,-7089,0.4577264755223425,0.5252973921000458,-0.06757091657770325
Louisiana,22019,Calcasieu Parish,55066,25982,82663,29084,0.6661505147405732,0.3143123283694035,0.3518381863711697
Louisiana,22021,Caldwell Parish,3976,745,4762,3231,0.8349433011339773,0.15644687106257874,0.6784964300713986
Louisiana,22023,Cameron Parish,3671,324,4039,3347,0.9088883386976975,0.08021787571180986,0.8286704629858876
Louisiana,22025,Catahoula Parish,3541,1269,4858,2272,0.7289007822149033,0.2612186084808563,0.46768217373404697
Louisiana,22027,Claiborne Parish,3770,2731,6580,1039,0.5729483282674772,0.41504559270516717,0.15790273556231005
Louisiana,22029,Concordia Parish,5550,3177,8828,2373,0.6286814680561849,0.3598776619845945,0.2688038060715904
Louisiana,22031,De Soto Parish,9112,5457,14736,3655,0.6183496199782845,0.37031758957654726,0.24803203040173727
Louisiana,22033,East Baton Rouge Parish,88420,115577,208182,-27157,0.424724519891249,0.5551728775782728,-0.13044835768702384
Louisiana,22035,East Carroll Parish,1080,1900,3036,-820,0.3557312252964427,0.6258234519104084,-0.27009222661396576
Louisiana,22037,East Feliciana Parish,6064,4280,10509,1784,0.5770292130554763,0.40726995908269104,0.16975925397278524
Louisiana,22039,Evangeline Parish,11053,4158,15412,6895,0.7171684401764858,0.2697897742019206,0.44737866597456527
Louisiana,22041,Franklin Parish,6970,2658,9720,4312,0.7170781893004116,0.2734567901234568,0.44362139917695476
Louisiana,22043,Grant Parish,8117,1157,9392,6960,0.8642461669505963,0.12318994889267462,0.7410562180579217
Louisiana,22045,Iberia Parish,21251,11027,32713,10224,0.649619417357014,0.33708311680371716,0.31253630055329684
Louisiana,22047,Iberville Parish,7893,8514,16719,-621,0.47209761349363,0.5092409833123991,-0.03714336981876909
Louisiana,22049,Jackson Parish,5394,2143,7632,3251,0.7067610062893082,0.28079140461215935,0.4259696016771488
Louisiana,22051,Jefferson Parish,105949,84477,193733,21472,0.5468815328312677,0.43604858232722354,0.11083295050404418
Louisiana,22053,Jefferson Davis Parish,11423,3208,14841,8215,0.7696920692675696,0.21615794083956608,0.5535341284280035
Louisiana,22055,Lafayette Parish,72519,39685,114521,32834,0.6332375721483396,0.346530330681709,0.2867072414666306
Louisiana,22057,Lafourche Parish,36024,8672,45388,27352,0.793689962104521,0.191063717282101,0.60262624482242
Louisiana,22059,LaSalle Parish,6378,638,7077,5740,0.9012293344637559,0.09015119400876077,0.811078140454995
Louisiana,22061,Lincoln Parish,11311,7559,19275,3752,0.586822308690013,0.39216601815823604,0.1946562905317769
Louisiana,22063,Livingston Parish,54877,9249,65230,45628,0.8412846849609076,0.1417905871531504,0.6994940978077572
Louisiana,22065,Madison Parish,1930,2654,4670,-724,0.4132762312633833,0.5683083511777302,-0.15503211991434684
Louisiana,22067,Morehouse Parish,6510,4946,11574,1564,0.5624675997926387,0.42733713495766373,0.13513046483497498
Louisiana,22069,Natchitoches Parish,9358,6896,16554,2462,0.5653014377189803,0.41657605412589105,0.1487253835930893
Louisiana,22071,Orleans Parish,26664,147854,177819,-121190,0.14995023029035143,0.8314859491955303,-0.6815357189051789
Louisiana,22073,Ouachita Parish,42255,25913,69166,16342,0.6109215510510945,0.37464939421102855,0.23627215684006592
Louisiana,22075,Plaquemines Parish,7412,3414,11014,3998,0.6729616851280189,0.30996913019792993,0.362992554930089
Louisiana,22077,Pointe Coupee Parish,7503,4683,12371,2820,0.6064990704065961,0.37854660092151,0.22795246948508613
Louisiana,22079,Rapides Parish,38347,19475,58865,18872,0.6514397349868343,0.33084175656162407,0.3205979784252102
Louisiana,22081,Red River Parish,2413,1644,4132,769,0.5839787028073572,0.3978702807357212,0.18610842207163597
Louisiana,22083,Richland Parish,6607,3225,9940,3382,0.6646881287726358,0.3244466800804829,0.34024144869215295
Louisiana,22085,Sabine Parish,8776,1731,10596,7045,0.8282370705926765,0.16336353340883353,0.664873537183843
Louisiana,22087,St. Bernard Parish,11179,6151,17650,5028,0.633371104815864,0.3484985835694051,0.2848725212464589
Louisiana,22089,St. Charles Parish,18233,9800,28517,8433,0.6393730055756216,0.34365466213136026,0.29571834344426134
Louisiana,22091,St. Helena Parish,2714,3346,6158,-632,0.4407275089314713,0.543358233192595,-0.10263072426112374
Louisiana,22093,St. James Parish,5954,6510,12590,-556,0.47291501191421764,0.517077045274027,-0.04416203335980934
Louisiana,22095,St. John the Baptist Parish,7538,13582,21432,-6044,0.3517170586039567,0.6337252706233669,-0.28200821201941023
Louisiana,22097,St. Landry Parish,23171,17372,41154,5799,0.5630315400690091,0.4221217864606114,0.14090975360839775
Louisiana,22099,St. Martin Parish,18203,8439,27038,9764,0.6732376655078038,0.31211628078999926,0.3611213847178046
Louisiana,22101,St. Mary Parish,14811,8055,23186,6756,0.6387906495298887,0.3474079185715518,0.29138273095833694
Louisiana,22103,St. Tammany Parish,99666,37746,140110,61920,0.7113410891442438,0.2694026122332453,0.44193847691099847
Louisiana,22105,Tangipahoa Parish,37806,18887,57661,18919,0.6556598047206951,0.32755241844574323,0.32810738627495184
Louisiana,22107,Tensas Parish,1197,1329,2554,-132,0.46867658574784654,0.5203602192638997,-0.05168363351605321
Louisiana,22109,Terrebonne Parish,34339,11198,46240,23141,0.7426254325259516,0.24217128027681661,0.500454152249135
Louisiana,22111,Union Parish,8407,2654,11201,5753,0.7505579858941166,0.23694313007767165,0.513614855816445
Louisiana,22113,Vermilion Parish,21930,5009,27324,16921,0.8025911286780852,0.1833186941882594,0.6192724344898258
Louisiana,22115,Vernon Parish,14107,2898,17268,11209,0.8169446374797313,0.16782487838776927,0.6491197590919621
Louisiana,22117,Washington Parish,13307,5970,19513,7337,0.6819556193307026,0.30594987956746783,0.37600573976323476
Louisiana,22119,Webster Parish,11830,6172,18216,5658,0.6494290733421169,0.3388230127360562,0.31060606060606066
Louisiana,22121,West Baton Rouge Parish,7684,6200,14097,1484,0.5450805135844506,0.4398098886287863,0.10527062495566436
Louisiana,22123,West Carroll Parish,4317,710,5052,3607,0.8545130641330166,0.1405384006334125,0.7139746634996041
Louisiana,22125,West Feliciana Parish,3863,2298,6268,1565,0.6163050414805361,0.3666241225271219,0.2496809189534142
Louisiana,22127,Winn Parish,4619,1543,6225,3076,0.7420080321285141,0.2478714859437751,0.494136546184739
Maine,23001,Androscoggin County,29268,27617,58707,1651,0.4985436149011191,0.4704209038104485,0.028122711090670605
Maine,23003,Aroostook County,21080,13956,35746,7124,0.5897163318972752,0.3904213058803782,0.19929502601689703
Maine,23005,Cumberland County,59584,128759,193765,-69175,0.3075065156245968,0.6645111346218358,-0.35700461899723895
Maine,23007,Franklin County,8754,8069,17390,685,0.5033927544565843,0.4640023001725129,0.03939045428407134
Maine,23009,Hancock County,14982,19369,35325,-4387,0.4241188959660297,0.5483085633404104,-0.12418966737438075
Maine,23011,Kennebec County,34721,34902,71858,-181,0.4831890673272287,0.4857079239611456,-0.002518856633916877
Maine,23013,Knox County,9982,15110,25734,-5128,0.3878915054014145,0.5871609543794202,-0.1992694489780057
Maine,23015,Lincoln County,10256,12684,23594,-2428,0.4346867847757905,0.5375943036365177,-0.10290751886072724
Maine,23017,Oxford County,17698,14755,33492,2943,0.5284246984354473,0.44055296787292486,0.0878717305625224
Maine,23019,Penobscot County,44825,37713,85269,7112,0.5256892891906789,0.44228265841044223,0.08340663078023669
Maine,23021,Piscataquis County,6143,3517,9908,2626,0.6200040371417037,0.3549656842955188,0.26503835284618493
Maine,23023,Sagadahoc County,9755,13528,24038,-3773,0.4058157916631999,0.5627756052916216,-0.1569598136284217
Maine,23025,Somerset County,16644,10199,27578,6445,0.6035245485531946,0.3698237725723403,0.23370077598085431
Maine,23027,Waldo County,11196,12345,24320,-1149,0.46036184210526315,0.5076069078947368,-0.047245065789473684
Maine,23029,Washington County,10194,6761,17357,3433,0.5873134758310768,0.3895258397188454,0.19778763611223144
Maine,23031,York County,54817,71189,129659,-16372,0.4227782105368698,0.54904788715014,-0.12626967661327015
Maryland,24001,Allegany County,20886,9158,30641,11728,0.6816357168499723,0.2988805848373095,0.38275513201266276
Maryland,24003,Anne Arundel County,127821,172823,309617,-45002,0.412835858496142,0.5581831746964798,-0.1453473162003378
Maryland,24005,Baltimore County,146202,258409,414932,-112207,0.3523517106417437,0.6227743341077574,-0.2704226234660137
Maryland,24009,Calvert County,25346,22587,49112,2759,0.5160856817071184,0.4599079654666884,0.05617771624043005
Maryland,24011,Caroline County,10283,5095,15794,5188,0.6510700265923769,0.3225908572875776,0.3284791693047993
Maryland,24013,Carroll County,60218,36456,100327,23762,0.6002172894634545,0.3633717742980454,0.23684551516540914
Maryland,24015,Cecil County,29439,16809,47462,12630,0.6202646327588387,0.354157009818381,0.2661076229404577
Maryland,24017,Charles County,25579,62171,89498,-36592,0.2858052693914948,0.6946635679009587,-0.4088582985094639
Maryland,24019,Dorchester County,8764,6857,15977,1907,0.5485385241284346,0.4291794454528385,0.11935907867559614
Maryland,24021,Frederick County,63682,77675,145615,-13993,0.43733131888885074,0.5334271881330906,-0.0960958692442399
Maryland,24023,Garrett County,12002,3281,15611,8721,0.7688168599064762,0.21017231439369674,0.5586445455127794
Maryland,24025,Harford County,80930,63095,148186,17835,0.5461379617507727,0.4257824625808106,0.12035549916996208
Maryland,24027,Howard County,48390,129433,183062,-81043,0.26433667282122997,0.7070446078377818,-0.4427079350165518
Maryland,24029,Kent County,5195,5329,10794,-134,0.48128589957383733,0.49370020381693536,-0.012414304243098029
Maryland,24031,Montgomery County,101222,419569,533743,-318347,0.18964557849002237,0.7860880611080614,-0.596442482618039
Maryland,24033,Prince George's County,37090,379208,424855,-342118,0.08730037306845866,0.8925586376528463,-0.8052582645843877
Maryland,24035,Queen Anne's County,18741,10709,30290,8032,0.6187190491911522,0.3535490260812149,0.26517002310993726
Maryland,24037,St. Mary's County,30826,23138,55665,7688,0.553777059193389,0.4156651396748406,0.13811191951854845
Maryland,24039,Somerset County,5739,4241,10147,1498,0.5655858874544201,0.4179560461220065,0.14762984133241358
Maryland,24041,Talbot County,10946,11062,22555,-116,0.4853025936599424,0.49044557747727774,-0.005142983817335356
Maryland,24043,Washington County,40224,26044,67779,14180,0.5934581507546586,0.3842488086280411,0.20920934212661746
Maryland,24045,Wicomico County,22944,22054,46216,890,0.496451445386879,0.47719404535225896,0.019257400034620065
Maryland,24047,Worcester County,18571,12560,31691,6011,0.5860023350478054,0.3963270329115522,0.18967530213625322
Maryland,24510,Baltimore city,25374,207260,237461,-181886,0.10685544152513465,0.8728170099511078,-0.7659615684259731
Massachusetts,25001,Barnstable County,55311,91994,150325,-36683,0.36794279062032265,0.6119674039580908,-0.24402461333776815
Massachusetts,25003,Berkshire County,18064,51705,71375,-33641,0.2530858143607706,0.7244133099824869,-0.4713274956217163
Massachusetts,25005,Bristol County,119872,153377,279279,-33505,0.42921952599371954,0.5491891620923879,-0.11996963609866834
Massachusetts,25007,Dukes County,2631,9914,12798,-7283,0.20557899671823723,0.7746522894202219,-0.5690732927019847
Massachusetts,25009,Essex County,144837,267198,421210,-122361,0.34385935756511005,0.634358158638209,-0.29049880107309894
Massachusetts,25011,Franklin County,11201,30030,42458,-18829,0.2638136511375948,0.7072872014696877,-0.4434735503320929
Massachusetts,25013,Hampden County,87318,125948,218177,-38630,0.40021633811079993,0.5772744148099938,-0.17705807669919382
Massachusetts,25015,Hampshire County,22281,63362,87854,-41081,0.25361395041773854,0.7212192956496005,-0.467605345231862
Massachusetts,25017,Middlesex County,226956,617196,863577,-390240,0.2628092225707725,0.7146971260235045,-0.45188790345273205
Massachusetts,25019,Nantucket County,1914,5241,7306,-3327,0.2619764577059951,0.7173555981385162,-0.45537914043252115
Massachusetts,25021,Norfolk County,125294,273312,407751,-148018,0.3072806688395614,0.6702914278567067,-0.3630107590171453
Massachusetts,25023,Plymouth County,121227,173630,301816,-52403,0.401658626447902,0.5752842791634638,-0.1736256527155618
Massachusetts,25025,Suffolk County,58613,270522,335462,-211909,0.17472321753283532,0.806416225980886,-0.6316930084480508
Massachusetts,25027,Worcester County,171683,248773,432014,-77090,0.3974014731004088,0.5758447642900462,-0.17844329118963737
Michigan,26001,Alcona County,4848,2142,7064,2706,0.6862967157417894,0.3032276330690827,0.38306908267270673
Michigan,26003,Alger County,3014,2053,5128,961,0.5877535101404057,0.4003510140405616,0.18740249609984405
Michigan,26005,Allegan County,41392,24449,67094,16943,0.6169255074969446,0.3643992011208156,0.25252630637612905
Michigan,26007,Alpena County,10686,6000,16969,4686,0.6297365784666156,0.3535859508515528,0.27615062761506276
Michigan,26009,Antrim County,9748,5960,15949,3788,0.6111981942441532,0.37369114051037683,0.2375070537337764
Michigan,26011,Arenac County,5928,2774,8831,3154,0.6712716566640244,0.31412071113124224,0.3571509455327822
Michigan,26013,Baraga County,2512,1478,4038,1034,0.6220901436354631,0.3660227835562159,0.2560673600792472
Michigan,26015,Barry County,23471,11797,35905,11674,0.6536972566494917,0.3285614816877872,0.32513577496170454
Michigan,26017,Bay County,33125,26151,60255,6974,0.54974690897021,0.4340054767239233,0.11574143224628664
Michigan,26019,Benzie County,6601,5480,12262,1121,0.538329799380199,0.44690915022019245,0.09142064916000653
Michigan,26021,Berrien County,43519,37438,82391,6081,0.5282008957289024,0.45439429063854064,0.07380660509036174
Michigan,26023,Branch County,14064,6159,20536,7905,0.6848461238800155,0.2999123490455785,0.384933774834437
Michigan,26025,Calhoun County,36221,28877,66281,7344,0.5464763657760142,0.4356753820853638,0.11080098369065039
Michigan,26027,Cass County,16699,9130,26216,7569,0.6369774183704607,0.3482606042111688,0.28871681415929196
Michigan,26029,Charlevoix County,9841,6939,17000,2902,0.5788823529411765,0.4081764705882353,0.1707058823529412
Michigan,26031,Cheboygan County,10186,5437,15868,4749,0.6419208469876481,0.34263927401058736,0.2992815729770607
Michigan,26033,Chippewa County,10681,6648,17642,4033,0.6054302233306881,0.3768280240335563,0.22860219929713177
Michigan,26035,Clare County,10861,5199,16281,5662,0.6670966156869971,0.3193292795282845,0.3477673361587126
Michigan,26037,Clinton County,25098,21968,47927,3130,0.5236714169466063,0.4583637615540301,0.06530765539257627
Michigan,26039,Crawford County,5087,2672,7861,2415,0.6471186871899249,0.339905864393843,0.3072128227960819
Michigan,26041,Delta County,13207,7606,21151,5601,0.6244149212803177,0.3596047468204813,0.2648101744598364
Michigan,26043,Dickinson County,9617,4744,14589,4873,0.6591952841181712,0.325176502844609,0.3340187812735622
Michigan,26045,Eaton County,31798,31299,64327,499,0.4943180934910691,0.4865608531409828,0.007757240350086292
Michigan,26047,Emmet County,12135,9662,22177,2473,0.5471885286558146,0.43567660188483565,0.11151192677097893
Michigan,26049,Genesee County,98714,119390,221360,-20676,0.44594325984821104,0.5393476689555475,-0.0934044091073365
Michigan,26051,Gladwin County,9893,4524,14603,5369,0.677463534890091,0.3097993562966514,0.36766417859343964
Michigan,26053,Gogebic County,4600,3570,8266,1030,0.5564964916525527,0.43188966852165495,0.12460682313089771
Michigan,26055,Grand Traverse County,30502,28683,60236,1819,0.5063749252938442,0.4761770369878478,0.0301978883059964
Michigan,26057,Gratiot County,12102,6693,19127,5409,0.6327181471218696,0.3499241909342814,0.2827939561875882
Michigan,26059,Hillsdale County,17037,5883,23302,11154,0.7311389580293537,0.25246759934769547,0.4786713586816582
Michigan,26061,Houghton County,10378,7750,18501,2628,0.5609426517485542,0.41889627587697964,0.14204637587157454
Michigan,26063,Huron County,12731,5490,18437,7241,0.6905136410478928,0.29777078700439336,0.39274285404349946
Michigan,26065,Ingham County,47639,94212,144550,-46573,0.3295676236596333,0.651760636457973,-0.3221930127983397
Michigan,26067,Ionia County,20657,10901,32209,9756,0.6413424819149927,0.33844577602533454,0.3028967058896581
Michigan,26069,Iosco County,9759,5373,15363,4386,0.6352274946299551,0.34973637961335674,0.28549111501659835
Michigan,26071,Iron County,4216,2493,6789,1723,0.6210045662100456,0.3672116659301812,0.25379290027986445
Michigan,26073,Isabella County,14815,14072,29421,743,0.5035518847082017,0.4782978144862513,0.025254070221950364
Michigan,26075,Jackson County,47372,31995,80861,15377,0.5858448448572241,0.39567900471178935,0.19016584014543475
Michigan,26077,Kalamazoo County,56823,83686,143414,-26863,0.39621654789630023,0.5835274101552149,-0.1873108622589147
Michigan,26079,Kalkaska County,7436,3002,10631,4434,0.6994638321888815,0.28238171385570504,0.4170821183331765
Michigan,26081,Kent County,165741,187915,361048,-22174,0.45905530566572866,0.5204709623097206,-0.0614156566439919
Michigan,26083,Keweenaw County,862,672,1557,190,0.5536287732819525,0.43159922928709055,0.12202954399486193
Michigan,26085,Lake County,3946,2288,6323,1658,0.6240708524434604,0.3618535505298118,0.2622173019136486
Michigan,26087,Lapeer County,35482,16367,52650,19115,0.6739221272554606,0.3108641975308642,0.36305792972459644
Michigan,26089,Leelanau County,7916,8795,16900,-879,0.46840236686390535,0.520414201183432,-0.052011834319526606
Michigan,26091,Lenawee County,31541,20918,53375,10623,0.5909320843091335,0.39190632318501173,0.19902576112412174
Michigan,26093,Livingston County,76982,48220,127197,28762,0.6052186765411134,0.3790969912812409,0.22612168525987247
Michigan,26095,Luce County,2109,842,3001,1267,0.7027657447517495,0.2805731422859047,0.4221926024658448
Michigan,26097,Mackinac County,4304,2632,7015,1672,0.6135424091233072,0.3751960085531005,0.23834640057020667
Michigan,26099,Macomb County,263863,223952,494256,39911,0.5338589718688291,0.45310931986662784,0.0807496520022013
Michigan,26101,Manistee County,8321,6107,14655,2214,0.5677925622654384,0.4167178437393381,0.15107471852610027
Michigan,26103,Marquette County,16286,20465,37462,-4179,0.43473386364849714,0.5462869040627836,-0.11155304041428643
Michigan,26105,Mason County,10207,6802,17254,3405,0.5915729685869944,0.39422742552451606,0.1973455430624783
Michigan,26107,Mecosta County,13267,7375,21049,5892,0.6302912252363533,0.3503729393320348,0.2799182859043185
Michigan,26109,Menominee County,8117,4316,12607,3801,0.6438486555088443,0.3423494883794717,0.3014991671293726
Michigan,26111,Midland County,27675,20493,49088,7182,0.5637834093872229,0.417474739243807,0.14630867014341592
Michigan,26113,Missaukee County,6648,1967,8755,4681,0.7593375214163335,0.22467161621930326,0.5346659051970302
Michigan,26115,Monroe County,52710,32975,87148,19735,0.6048331573874328,0.37837930876210585,0.22645384862532697
Michigan,26117,Montcalm County,21815,9703,32100,12112,0.679595015576324,0.30227414330218066,0.3773208722741433
Michigan,26119,Montmorency County,4171,1628,5859,2543,0.7118962280252603,0.277863116572794,0.4340331114524663
Michigan,26121,Muskegon County,45133,45643,92444,-510,0.4882198952879581,0.4937367487343689,-0.0055168534464107855
Michigan,26123,Newaygo County,18857,7873,27161,10984,0.6942675159235668,0.2898641434409632,0.40440337248260366
Michigan,26125,Oakland County,325971,434148,770351,-108177,0.42314607237480056,0.56357167057614,-0.14042559820133943
Michigan,26127,Oceana County,8892,4944,14062,3948,0.6323424832882947,0.35158583416299244,0.28075664912530224
Michigan,26129,Ogemaw County,8253,3475,11907,4778,0.6931216931216931,0.2918451331149744,0.40127656000671874
Michigan,26131,Ontonagon County,2358,1391,3804,967,0.6198738170347003,0.3656677181913775,0.25420609884332285
Michigan,26133,Osceola County,8928,3214,12329,5714,0.7241463216805905,0.2606861870386893,0.46346013464190117
Michigan,26135,Oscoda County,3466,1342,4874,2124,0.7111202297907263,0.275338530980714,0.43578169881001233
Michigan,26137,Otsego County,9779,4743,14757,5036,0.6626685640712882,0.32140678999796707,0.3412617740733211
Michigan,26139,Ottawa County,100913,64705,168713,36208,0.5981341094047288,0.38352112759538387,0.2146129818093449
Michigan,26141,Presque Isle County,5342,2911,8344,2431,0.6402205177372963,0.34887344199424736,0.2913470757430489
Michigan,26143,Roscommon County,9670,5166,15018,4504,0.6438939938740178,0.3439872153415901,0.2999067785324277
Michigan,26145,Saginaw County,50785,51088,103349,-303,0.49139324037968435,0.4943250539434344,-0.002931813563750052
Michigan,26147,St. Clair County,59185,31363,92064,27822,0.64286800486618,0.3406651894334376,0.3022028154327424
Michigan,26149,St. Joseph County,18127,9262,27936,8865,0.6488760022909508,0.3315435280641466,0.31733247422680416
Michigan,26151,Sanilac County,16194,5966,22446,10228,0.7214648489708634,0.26579345985921765,0.45567138911164573
Michigan,26153,Schoolcraft County,3090,1589,4745,1501,0.6512118018967334,0.33487881981032663,0.3163329820864068
Michigan,26155,Shiawassee County,23149,15347,39224,7802,0.5901743830307975,0.39126555170303895,0.19890883132775855
Michigan,26157,Tuscola County,20297,8712,29445,11585,0.6893190694515198,0.29587366276107996,0.3934454066904398
Michigan,26159,Van Buren County,21591,16803,39066,4788,0.5526800798648441,0.43011826140377823,0.1225618184610659
Michigan,26161,Washtenaw County,56241,157136,216418,-100895,0.2598720993632692,0.72607638920977,-0.4662042898465008
Michigan,26163,Wayne County,264553,597170,872469,-332617,0.3032233810026488,0.6844598490032311,-0.3812364680005823
Michigan,26165,Wexford County,12102,5838,18265,6264,0.6625787024363536,0.3196277032575965,0.34295099917875715
Minnesota,27001,Aitkin County,6258,3607,10025,2651,0.6242394014962593,0.3598004987531172,0.26443890274314213
Minnesota,27003,Anoka County,104902,100893,211132,4009,0.49685504802682684,0.4778669268514484,0.01898812117537846
Minnesota,27005,Becker County,12438,6589,19401,5849,0.6411009741765888,0.3396216689861347,0.3014793051904541
Minnesota,27007,Beltrami County,12188,11426,24189,762,0.5038653933606184,0.4723634709992145,0.03150192236140392
Minnesota,27009,Benton County,14382,7280,22260,7102,0.6460916442048518,0.3270440251572327,0.3190476190476191
Minnesota,27011,Big Stone County,1863,1053,2974,810,0.6264290517821116,0.35406859448554134,0.27236045729657027
Minnesota,27013,Blue Earth County,16731,18330,36051,-1599,0.46409253557460267,0.5084463676458351,-0.04435383207123239
Minnesota,27015,Brown County,9552,4753,14635,4799,0.6526819268875982,0.32476938845234027,0.3279125384352579
Minnesota,27017,Carlton County,9791,10098,20369,-307,0.4806814276596789,0.49575335067995485,-0.015071923020275935
Minnesota,27019,Carver County,34009,30774,66361,3235,0.5124847425445669,0.4637362306173807,0.04874851192718621
Minnesota,27021,Cass County,11620,6342,18289,5278,0.6353545847230576,0.34676581551752417,0.28858876920553345
Minnesota,27023,Chippewa County,4250,2226,6611,2024,0.6428679473604598,0.3367115413704432,0.30615640599001664
Minnesota,27025,Chisago County,21916,11806,34570,10110,0.6339600809950824,0.3415099797512294,0.292450101243853
Minnesota,27027,Clay County,15043,16357,32239,-1314,0.4666087657805763,0.5073668538106021,-0.040758088030025785
Minnesota,27029,Clearwater County,3372,1260,4708,2112,0.7162276975361087,0.2676295666949873,0.44859813084112143
Minnesota,27031,Cook County,1203,2496,3806,-1293,0.3160798738833421,0.6558066211245402,-0.33972674724119817
Minnesota,27033,Cottonwood County,4165,1834,6107,2331,0.6820042574095301,0.30031111838873426,0.3816931390207958
Minnesota,27035,Crow Wing County,25676,13726,40173,11950,0.6391357379334379,0.3416722674433077,0.2974634704901302
Minnesota,27037,Dakota County,109638,146155,262259,-36517,0.418052383330982,0.5572926000632962,-0.13924021673231418
Minnesota,27039,Dodge County,7783,4079,12187,3704,0.6386313284647576,0.3347009108065972,0.30393041765816037
Minnesota,27041,Douglas County,15799,7868,24165,7931,0.6537968135733498,0.3255948686116284,0.32820194496172145
Minnesota,27043,Faribault County,5191,2531,7914,2660,0.6559262067222643,0.3198129896386151,0.3361132170836492
Minnesota,27045,Fillmore County,7301,4551,12141,2750,0.6013507948274442,0.37484556461576474,0.2265052302116795
Minnesota,27047,Freeborn County,9578,6889,16818,2689,0.5695088595552384,0.4096206445475086,0.15988821500772982
Minnesota,27049,Goodhue County,16052,11806,28636,4246,0.5605531498812684,0.4122782511523956,0.14827489872887278
Minnesota,27051,Grant County,2269,1300,3654,969,0.6209633278598796,0.35577449370552816,0.26518883415435146
Minnesota,27053,Hennepin County,205973,532623,755969,-326650,0.2724622305941117,0.7045566683289923,-0.43209443773488065
Minnesota,27055,Houston County,6334,4853,11440,1481,0.5536713286713286,0.42421328671328673,0.1294580419580419
Minnesota,27057,Hubbard County,8202,4462,12965,3740,0.63262630158118,0.344157346702661,0.28846895487851903
Minnesota,27059,Isanti County,16491,7138,24235,9353,0.6804621415308438,0.2945327006395709,0.38592944089127296
Minnesota,27061,Itasca County,15239,10786,26561,4453,0.5737359286171454,0.4060841082790558,0.16765182033808962
Minnesota,27063,Jackson County,3948,1745,5819,2203,0.6784670905653892,0.2998797044165664,0.3785873861488228
Minnesota,27065,Kanabec County,6278,2774,9242,3504,0.679290196927072,0.3001514823631249,0.37913871456394715
Minnesota,27067,Kandiyohi County,14437,8440,23367,5997,0.6178371207258099,0.36119313561860744,0.25664398510720243
Minnesota,27069,Kittson County,1546,1006,2639,540,0.5858279651383099,0.38120500189465706,0.20462296324365287
Minnesota,27071,Koochiching County,4131,2659,6922,1472,0.596792834440913,0.38413753250505633,0.2126553019358567
Minnesota,27073,Lac qui Parle County,2528,1446,4040,1082,0.6257425742574257,0.3579207920792079,0.26782178217821784
Minnesota,27075,Lake County,3393,3647,7202,-254,0.4711191335740072,0.5063871146903638,-0.035267981116356595
Minnesota,27077,Lake of the Woods County,1704,671,2408,1033,0.707641196013289,0.27865448504983387,0.42898671096345514
Minnesota,27079,Le Sueur County,10775,5672,16818,5103,0.6406826019740754,0.3372577000832441,0.3034249018908313
Minnesota,27081,Lincoln County,2121,937,3115,1184,0.6808988764044944,0.30080256821829854,0.3800963081861959
Minnesota,27083,Lyon County,7979,4634,12893,3345,0.6188629488869929,0.35941984022337703,0.25944310866361586
Minnesota,27085,McLeod County,13986,6413,20933,7573,0.6681316581474227,0.3063583815028902,0.3617732766445325
Minnesota,27087,Mahnomen County,1142,1112,2304,30,0.4956597222222222,0.4826388888888889,0.013020833333333315
Minnesota,27089,Marshall County,3721,1295,5113,2426,0.727752787013495,0.25327596323097984,0.47447682378251516
Minnesota,27091,Martin County,7480,3305,11009,4175,0.6794440911981107,0.3002089199745663,0.3792351712235444
Minnesota,27093,Meeker County,9359,3867,13529,5492,0.6917732278808485,0.28583043831768795,0.40594278956316054
Minnesota,27095,Mille Lacs County,9952,4404,14689,5548,0.6775137858261284,0.2998161889849547,0.3776975968411737
Minnesota,27097,Morrison County,14821,4367,19558,10454,0.7577973207894467,0.2232845894263217,0.534512731363125
Minnesota,27099,Mower County,10025,8899,19345,1126,0.5182217627293875,0.46001550788317397,0.0582062548462135
Minnesota,27101,Murray County,3363,1449,4896,1914,0.6868872549019608,0.2959558823529412,0.3909313725490196
Minnesota,27103,Nicollet County,9018,9622,19125,-604,0.47152941176470586,0.5031111111111111,-0.0315816993464052
Minnesota,27105,Nobles County,5600,2933,8715,2667,0.642570281124498,0.3365461847389558,0.3060240963855422
Minnesota,27107,Norman County,1953,1404,3441,549,0.5675675675675675,0.4080209241499564,0.15954664341761116
Minnesota,27109,Olmsted County,39692,49491,91385,-9799,0.4343382393171746,0.5415659025004104,-0.10722766318323579
Minnesota,27111,Otter Tail County,23800,11958,36399,11842,0.6538641171460754,0.3285255089425534,0.325338608203522
Minnesota,27113,Pennington County,4532,2568,7277,1964,0.6227841143328294,0.35289267555311254,0.2698914387797169
Minnesota,27115,Pine County,10256,5419,16001,4837,0.6409599400037498,0.33866633335416535,0.30229360664958443
Minnesota,27117,Pipestone County,3553,1306,4940,2247,0.7192307692307692,0.26437246963562755,0.4548582995951417
Minnesota,27119,Polk County,9865,5439,15594,4426,0.632615108375016,0.34878799538283956,0.28382711299217644
Minnesota,27121,Pope County,4417,2477,7022,1940,0.6290230703503276,0.3527485046995158,0.27627456565081177
Minnesota,27123,Ramsey County,77376,211620,295977,-134244,0.2614257188903192,0.7149879889315723,-0.45356227004125316
Minnesota,27125,Red Lake County,1454,691,2196,763,0.6621129326047359,0.3146630236794171,0.3474499089253188
Minnesota,27127,Redwood County,5771,2355,8284,3416,0.6966441332689522,0.2842829550941574,0.41236117817479484
Minnesota,27129,Renville County,5467,2496,8128,2971,0.672613188976378,0.30708661417322836,0.36552657480314965
Minnesota,27131,Rice County,17464,17402,35686,62,0.4893795886341983,0.48764221263240487,0.0017373760017934115
Minnesota,27133,Rock County,3583,1556,5240,2027,0.6837786259541985,0.2969465648854962,0.38683206106870227
Minnesota,27135,Roseau County,6065,2188,8421,3877,0.7202232513953212,0.2598266239163995,0.4603966274789217
Minnesota,27137,St. Louis County,49017,67704,119531,-18687,0.41007772042399043,0.5664137336757828,-0.15633601325179242
Minnesota,27139,Scott County,45872,40040,87965,5832,0.521480134144262,0.45518103791280623,0.06629909623145575
Minnesota,27141,Sherburne County,36222,18065,55612,18157,0.6513342444076818,0.3248399625980004,0.32649428180968143
Minnesota,27143,Sibley County,5864,2417,8452,3447,0.69380028395646,0.2859678182678656,0.4078324656885944
Minnesota,27145,Stearns County,50959,31879,84835,19080,0.6006836800848706,0.37577650733777335,0.22490717274709726
Minnesota,27147,Steele County,12656,7917,21128,4739,0.5990155244225672,0.3747160166603559,0.2242995077622113
Minnesota,27149,Stevens County,3044,1922,5085,1122,0.5986234021632252,0.37797443461160274,0.22064896755162244
Minnesota,27151,Swift County,3316,1784,5193,1532,0.6385518967841325,0.34353937993452727,0.2950125168496052
Minnesota,27153,Todd County,9753,3286,13257,6467,0.7356868069699027,0.24786905031304216,0.48781775665686056
Minnesota,27155,Traverse County,1172,661,1864,511,0.628755364806867,0.3546137339055794,0.2741416309012876
Minnesota,27157,Wabasha County,8153,4696,13123,3457,0.6212756229520688,0.3578450049531357,0.26343061799893314
Minnesota,27159,Wadena County,5520,2023,7677,3497,0.719030871434154,0.2635143936433503,0.45551647779080373
Minnesota,27161,Waseca County,6624,3496,10389,3128,0.6375974588507075,0.3365097699489845,0.301087688901723
Minnesota,27163,Washington County,73764,89165,166786,-15401,0.4422673365870037,0.5346072212295996,-0.0923398846425959
Minnesota,27165,Watonwan County,3103,1987,5201,1116,0.5966160353778119,0.382041915016343,0.21457412036146895
Minnesota,27167,Wilkin County,2328,1026,3430,1302,0.6787172011661807,0.2991253644314869,0.3795918367346938
Minnesota,27169,Winona County,13227,13333,27173,-106,0.48676995547050383,0.4906708865417878,-0.003900931071283975
Minnesota,27171,Wright County,51973,28430,82426,23543,0.6305413340450828,0.3449154393031325,0.2856258947419503
Minnesota,27173,Yellow Medicine County,3734,1688,5528,2046,0.6754703328509407,0.3053545586107091,0.3701157742402316
Mississippi,28001,Adams County,5696,7917,13759,-2221,0.4139835743876735,0.5754051893306199,-0.16142161494294638
Mississippi,28003,Alcorn County,12818,2782,15811,10036,0.8107014104104737,0.17595345012965657,0.6347479602808171
Mississippi,28005,Amite County,4503,2620,7207,1883,0.6248092132648814,0.3635354516442348,0.2612737616206466
Mississippi,28007,Attala County,5178,3542,8832,1636,0.5862771739130435,0.4010416666666667,0.18523550724637677
Mississippi,28009,Benton County,2570,1679,4292,891,0.5987884436160298,0.39119291705498604,0.20759552656104374
Mississippi,28011,Bolivar County,4671,8904,13755,-4233,0.3395856052344602,0.6473282442748092,-0.307742639040349
Mississippi,28013,Calhoun County,4625,1902,6595,2723,0.7012888551933283,0.2884003032600455,0.4128885519332828
Mississippi,28015,Carroll County,3924,1729,5705,2195,0.6878177037686241,0.3030674846625767,0.38475021910604734
Mississippi,28017,Chickasaw County,4175,3810,8148,365,0.5123956799214531,0.46759941089838,0.0447962690230731
Mississippi,28019,Choctaw County,3001,1185,4225,1816,0.7102958579881656,0.2804733727810651,0.42982248520710054
Mississippi,28021,Claiborne County,603,3772,4453,-3169,0.13541432741971704,0.8470693914215136,-0.7116550640017966
Mississippi,28023,Clarke County,5417,2838,8347,2579,0.6489756798849886,0.34000239607044447,0.30897328381454414
Mississippi,28025,Clay County,4181,5844,10206,-1663,0.4096609837350578,0.5726043503821282,-0.16294336664707038
Mississippi,28027,Coahoma County,2375,6020,8507,-3645,0.279181850240978,0.7076525214529211,-0.4284706712119431
Mississippi,28029,Copiah County,6250,6470,12897,-220,0.484608823757463,0.5016670543537257,-0.017058230596262713
Mississippi,28031,Covington County,5854,3416,9371,2438,0.624693202433038,0.3645288656493437,0.2601643367836943
Mississippi,28033,DeSoto County,46462,28265,76248,18197,0.609353687965586,0.37069824782289373,0.23865544014269224
Mississippi,28035,Forrest County,17290,13755,31725,3535,0.5449960598896769,0.4335697399527187,0.11142631993695823
Mississippi,28037,Franklin County,2923,1480,4464,1443,0.6547939068100358,0.33154121863799285,0.32325268817204295
Mississippi,28039,George County,9713,1218,11064,8495,0.8778922631959508,0.11008676789587853,0.7678054953000722
Mississippi,28041,Greene County,4794,966,5816,3828,0.8242778541953233,0.16609353507565336,0.6581843191196699
Mississippi,28043,Grenada County,6081,4734,10919,1347,0.5569191317886253,0.4335561864639619,0.12336294532466341
Mississippi,28045,Hancock County,16132,4504,20957,11628,0.7697666650761082,0.21491625709786707,0.5548504079782411
Mississippi,28047,Harrison County,46822,27728,75865,19094,0.6171752455018783,0.36549133328939565,0.25168391221248265
Mississippi,28049,Hinds County,25141,73550,100191,-48409,0.2509307223203681,0.7340978730624507,-0.48316715074208255
Mississippi,28051,Holmes County,1369,6588,8115,-5219,0.1686999383857055,0.811829944547135,-0.6431300061614295
Mississippi,28053,Humphreys County,1118,3016,4189,-1898,0.26688947242778704,0.7199809023633326,-0.4530914299355455
Mississippi,28055,Issaquena County,308,355,676,-47,0.4556213017751479,0.5251479289940828,-0.06952662721893488
Mississippi,28057,Itawamba County,9438,1249,10826,8189,0.8717901348605209,0.1153704045815629,0.756419730278958
Mississippi,28059,Jackson County,36295,17375,54623,18920,0.6644636874576644,0.3180894494992952,0.3463742379583692
Mississippi,28061,Jasper County,4302,4341,8742,-39,0.4921070693205216,0.49656829100892247,-0.0044612216884008515
Mississippi,28063,Jefferson County,531,3327,3911,-2796,0.13577090258245972,0.8506775760675019,-0.7149066734850422
Mississippi,28065,Jefferson Davis County,2534,3599,6213,-1065,0.4078544986319009,0.5792692741026879,-0.17141477547078704
Mississippi,28067,Jones County,21226,8517,30091,12709,0.7053936392941411,0.283041440962414,0.4223521983317271
Mississippi,28069,Kemper County,1787,2887,4732,-1100,0.3776415891800507,0.6101014370245139,-0.23245984784446322
Mississippi,28071,Lafayette County,12949,10070,23481,2879,0.5514671436480558,0.4288573740471019,0.12260976960095393
Mississippi,28073,Lamar County,20704,7340,28526,13364,0.725794012479843,0.2573091215031901,0.4684848909766529
Mississippi,28075,Lauderdale County,17967,12960,31266,5007,0.5746497793129918,0.41450777202072536,0.1601420072922664
Mississippi,28077,Lawrence County,4285,2260,6617,2025,0.6475744294997733,0.3415445065739761,0.30602992292579717
Mississippi,28079,Leake County,5228,3897,9204,1331,0.5680139069969579,0.42340286831812257,0.1446110386788353
Mississippi,28081,Lee County,24207,12189,37003,12018,0.6541902007945302,0.32940572386022754,0.3247844769343026
Mississippi,28083,Leflore County,3129,7648,10893,-4519,0.28724869182043516,0.7021022675112457,-0.41485357569081055
Mississippi,28085,Lincoln County,11596,5040,16818,6556,0.689499345938875,0.29967891544773456,0.3898204304911404
Mississippi,28087,Lowndes County,13800,13087,27273,713,0.5059949400505995,0.4798518681479852,0.026143071902614334
Mississippi,28089,Madison County,31091,24440,56335,6651,0.5518949143516464,0.4338333185408716,0.1180615958107748
Mississippi,28091,Marion County,8273,3787,12194,4486,0.6784484172543874,0.3105625717566016,0.3678858454977858
Mississippi,28093,Marshall County,7566,8057,15830,-491,0.4779532533164877,0.5089703095388503,-0.03101705622236256
Mississippi,28095,Monroe County,11177,5874,17279,5303,0.646854563342786,0.3399502286011922,0.30690433474159384
Mississippi,28097,Montgomery County,2917,2121,5078,796,0.5744387554155179,0.417684127609295,0.1567546278062229
Mississippi,28099,Neshoba County,8320,3260,11720,5060,0.7098976109215017,0.2781569965870307,0.43174061433447103
Mississippi,28101,Newton County,6997,3075,10189,3922,0.6867209735989793,0.3017960545686525,0.38492491903032683
Mississippi,28103,Noxubee County,1240,4040,5341,-2800,0.23216626099981277,0.7564126568058416,-0.5242463958060288
Mississippi,28105,Oktibbeha County,9004,10299,19812,-1295,0.4544720371492025,0.5198364627498486,-0.06536442560064615
Mississippi,28107,Panola County,8060,7403,15635,657,0.5155100735529261,0.4734889670610809,0.042021106491845206
Mississippi,28109,Pearl River County,19595,4148,24056,15447,0.8145576987030263,0.17243099434652479,0.6421267043565015
Mississippi,28111,Perry County,4500,1362,5922,3138,0.7598784194528876,0.22998986828774062,0.529888551165147
Mississippi,28113,Pike County,8479,8646,17360,-167,0.4884216589861751,0.49804147465437787,-0.009619815668202747
Mississippi,28115,Pontotoc County,11550,2614,14377,8936,0.8033664881407804,0.18181818181818182,0.6215483063225986
Mississippi,28117,Prentiss County,8370,2153,10661,6217,0.7851045868117438,0.2019510364881343,0.5831535503236095
Mississippi,28119,Quitman County,1026,2150,3229,-1124,0.31774543202229794,0.6658408175905853,-0.3480953855682874
Mississippi,28121,Rankin County,50895,18847,70655,32048,0.7203311867525299,0.26674686858679497,0.45358431816573497
Mississippi,28123,Scott County,6285,4330,10744,1955,0.5849776619508563,0.4030156366344006,0.18196202531645572
Mississippi,28125,Sharkey County,688,1465,2183,-777,0.315162620247366,0.6710948236371965,-0.3559322033898305
Mississippi,28127,Simpson County,7635,4037,11820,3598,0.6459390862944162,0.3415397631133672,0.304399323181049
Mississippi,28129,Smith County,6458,1791,8327,4667,0.7755494175573436,0.21508346343220847,0.5604659541251351
Mississippi,28131,Stone County,5964,1802,7878,4162,0.7570449352627571,0.22873825844122875,0.5283066768215283
Mississippi,28133,Sunflower County,2799,6781,9683,-3982,0.2890633068263968,0.7002994939584839,-0.4112361871320871
Mississippi,28135,Tallahatchie County,2488,3105,5691,-617,0.4371815146722896,0.5455983131259884,-0.10841679845369878
Mississippi,28137,Tate County,8707,4183,13101,4524,0.6646057552858561,0.3192886039233646,0.34531715136249147
Mississippi,28139,Tippah County,8054,1937,10102,6117,0.7972678677489606,0.19174420906751138,0.6055236586814492
Mississippi,28141,Tishomingo County,7933,1059,9147,6874,0.8672788892533071,0.11577566415218105,0.751503225101126
Mississippi,28143,Tunica County,926,2580,3565,-1654,0.2597475455820477,0.7237026647966339,-0.4639551192145862
Mississippi,28145,Union County,10373,2160,12683,8213,0.8178664353859497,0.1703067097689821,0.6475597256169676
Mississippi,28147,Walthall County,4220,2835,7122,1385,0.5925301881493963,0.3980623420387532,0.1944678461106431
Mississippi,28149,Warren County,10365,10442,21056,-77,0.49225873860182373,0.49591565349544076,-0.003656914893617025
Mississippi,28151,Washington County,5300,12503,18025,-7203,0.29403606102635227,0.6936477115117892,-0.3996116504854369
Mississippi,28153,Wayne County,6307,3624,10065,2683,0.6266269249875808,0.3600596125186289,0.2665673124689519
Mississippi,28155,Webster County,4291,1043,5402,3248,0.7943354313217327,0.19307663828211774,0.6012587930396149
Mississippi,28157,Wilkinson County,1324,2749,4130,-1425,0.32058111380145277,0.6656174334140436,-0.3450363196125908
Mississippi,28159,Winston County,5112,4040,9244,1072,0.5530073561228905,0.4370402423193423,0.11596711380354824
Mississippi,28161,Yalobusha County,3671,2785,6538,886,0.561486693178342,0.42597124502906086,0.13551544814928113
Mississippi,28163,Yazoo County,4832,5496,10441,-664,0.4627909204099224,0.5263863614596304,-0.06359544104970793
Missouri,29001,Adair County,6413,3710,10336,2703,0.620452786377709,0.3589396284829721,0.26151315789473684
Missouri,29003,Andrew County,7255,2351,9752,4904,0.7439499589827727,0.24107875307629203,0.5028712059064807
Missouri,29005,Atchison County,2199,564,2814,1635,0.7814498933901919,0.20042643923240938,0.5810234541577826
Missouri,29007,Audrain County,7732,2704,10656,5028,0.7256006006006006,0.25375375375375375,0.47184684684684686
Missouri,29009,Barry County,12425,2948,15598,9477,0.7965764841646364,0.18899858956276447,0.607577894601872
Missouri,29011,Barton County,5168,844,6077,4324,0.850419614941583,0.13888431792002634,0.7115352970215567
Missouri,29013,Bates County,6597,1672,8416,4925,0.7838640684410646,0.19866920152091255,0.5851948669201521
Missouri,29015,Benton County,8109,2180,10476,5929,0.7740549828178694,0.2080946926307751,0.5659602901870944
Missouri,29017,Bollinger County,5167,750,5983,4417,0.863613571786729,0.12535517299013874,0.7382583987965903
Missouri,29019,Boone County,38646,50064,91168,-11418,0.4238987363987364,0.5491400491400491,-0.12524131274131273
Missouri,29021,Buchanan County,22450,13445,36598,9005,0.6134214984425378,0.3673698016285043,0.2460516968140335
Missouri,29023,Butler County,14602,3301,18141,11301,0.8049170387519983,0.18196350807562978,0.6229535306763685
Missouri,29025,Caldwell County,3725,897,4682,2828,0.7956001708671507,0.19158479282357968,0.6040153780435711
Missouri,29027,Callaway County,14815,5870,21144,8945,0.7006715853197124,0.27762012864169505,0.42305145667801736
Missouri,29029,Camden County,18850,5652,24812,13198,0.7597130420764147,0.22779300338545866,0.5319200386909559
Missouri,29031,Cape Girardeau County,28907,10760,40328,18147,0.716797262447927,0.26681214044832374,0.4499851219996032
Missouri,29033,Carroll County,3706,786,4532,2920,0.8177405119152692,0.1734333627537511,0.6443071491615181
Missouri,29035,Carter County,2451,418,2897,2033,0.8460476354849845,0.144287193648602,0.7017604418363825
Missouri,29037,Cass County,37197,19052,57408,18145,0.6479410535117057,0.3318701226309922,0.31607093088071353
Missouri,29039,Cedar County,5788,1145,7044,4643,0.8216922203293583,0.16254968767745598,0.6591425326519023
Missouri,29041,Chariton County,3111,916,4077,2195,0.7630610743193524,0.2246750061319598,0.5383860681873927
Missouri,29043,Christian County,34920,11131,46839,23789,0.745532569013002,0.23764384380537587,0.5078887252076262
Missouri,29045,Clark County,2672,678,3394,1994,0.7872716558632882,0.19976428992339423,0.5875073659398939
Missouri,29047,Clay County,64605,59400,126569,5205,0.5104330444263603,0.46930923053828344,0.04112381388807684
Missouri,29049,Clinton County,7799,2896,10888,4903,0.7162931667891257,0.2659808963997061,0.45031227038941957
Missouri,29051,Cole County,26086,12694,39529,13392,0.6599205646487389,0.3211313213084065,0.33878924334033245
Missouri,29053,Cooper County,6272,2249,8693,4023,0.7215000575175429,0.25871390774186126,0.4627861497756816
Missouri,29055,Crawford County,8725,2113,10973,6612,0.7951335095233756,0.19256356511437164,0.6025699444090039
Missouri,29057,Dade County,3414,656,4119,2758,0.8288419519300801,0.15926195678562757,0.6695799951444525
Missouri,29059,Dallas County,6619,1380,8104,5239,0.8167571569595261,0.1702862783810464,0.6464708785784797
Missouri,29061,Daviess County,3102,746,3911,2356,0.793147532600358,0.19074405522884172,0.6024034773715162
Missouri,29063,DeKalb County,3828,930,4843,2898,0.7904191616766467,0.19202973363617593,0.5983894280404708
Missouri,29065,Dent County,5987,1056,7142,4931,0.8382805936712405,0.1478577429291515,0.6904228507420891
Missouri,29067,Douglas County,5898,1016,7000,4882,0.8425714285714285,0.14514285714285713,0.6974285714285714
Missouri,29069,Dunklin County,8135,2200,10419,5935,0.7807851041366733,0.21115270179479798,0.5696324023418754
Missouri,29071,Franklin County,38058,14569,53685,23489,0.7089131042190556,0.2713793424606501,0.4375337617584055
Missouri,29073,Gasconade County,6222,1601,7923,4621,0.7853085952290799,0.20206992300896126,0.5832386722201186
Missouri,29075,Gentry County,2581,613,3237,1968,0.797343219029966,0.18937287611986406,0.6079703429101019
Missouri,29077,Greene County,83630,55068,141800,28562,0.5897743300423132,0.38834978843441464,0.20142454160789852
Missouri,29079,Grundy County,3585,799,4437,2786,0.8079783637592968,0.18007662835249041,0.6279017354068064
Missouri,29081,Harrison County,3198,597,3826,2601,0.8358599059069525,0.1560376372190277,0.6798222686879247
Missouri,29083,Henry County,8027,2619,10788,5408,0.7440674823878384,0.24276974416017796,0.5012977382276604
Missouri,29085,Hickory County,3966,1056,5080,2910,0.7807086614173229,0.2078740157480315,0.5728346456692914
Missouri,29087,Holt County,1976,338,2343,1638,0.8433632095603927,0.14425949637217242,0.6991037131882203
Missouri,29089,Howard County,3553,1413,5092,2140,0.6977611940298507,0.2774941084053417,0.420267085624509
Missouri,29091,Howell County,15181,3218,18650,11963,0.8139946380697051,0.17254691689008042,0.6414477211796247
Missouri,29093,Iron County,3596,945,4592,2651,0.7831010452961672,0.20579268292682926,0.5773083623693379
Missouri,29095,Jackson County,126535,199842,333063,-73307,0.37991310953183033,0.600012610226894,-0.22009950069506368
Missouri,29097,Jasper County,37728,13549,52352,24179,0.7206601466992665,0.25880577628361856,0.4618543704156479
Missouri,29099,Jefferson County,77046,37523,116688,39523,0.6602735499794323,0.32156691347867816,0.33870663650075417
Missouri,29101,Johnson County,15489,6974,23123,8515,0.6698525277861869,0.30160446308869954,0.36824806469748733
Missouri,29103,Knox County,1486,340,1854,1146,0.8015102481121898,0.18338727076591155,0.6181229773462783
Missouri,29105,Laclede County,13762,2780,16793,10982,0.8195081283868278,0.16554516762936938,0.6539629607574584
Missouri,29107,Lafayette County,12273,4472,17055,7801,0.719613016710642,0.26221049545587805,0.457402521254764
Missouri,29109,Lawrence County,14426,3214,17905,11212,0.8056967327562133,0.1795029321418598,0.6261938006143535
Missouri,29111,Lewis County,3553,984,4609,2569,0.7708830548926014,0.2134953352137123,0.5573877196788891
Missouri,29113,Lincoln County,21848,6607,29018,15241,0.7529119856640706,0.2276862636983941,0.5252257219656765
Missouri,29115,Linn County,4363,1275,5726,3088,0.7619629758994062,0.22266852951449528,0.539294446384911
Missouri,29117,Livingston County,5267,1410,6758,3857,0.7793725954424386,0.20864160994377035,0.5707309854986683
Missouri,29119,McDonald County,7465,1439,9053,6026,0.8245885341875622,0.15895283331492324,0.6656357008726389
Missouri,29121,Macon County,6076,1662,7836,4414,0.7753956100051046,0.2120980091883614,0.5632976008167432
Missouri,29123,Madison County,4584,1019,5676,3565,0.8076109936575053,0.17952783650458068,0.6280831571529246
Missouri,29125,Maries County,3892,814,4771,3078,0.8157618947809684,0.17061412701739678,0.6451477677635716
Missouri,29127,Marion County,9915,3202,13348,6713,0.7428079112975726,0.23988612526221156,0.5029217860353611
Missouri,29129,Mercer County,1541,222,1779,1319,0.8662169758291175,0.12478920741989882,0.7414277684092186
Missouri,29131,Miller County,10176,2038,12382,8138,0.821838152156356,0.16459376514294943,0.6572443870134066
Missouri,29133,Mississippi County,3537,1178,4756,2359,0.7436921783010934,0.24768713204373424,0.4960050462573591
Missouri,29135,Moniteau County,5744,1308,7157,4436,0.802570909598994,0.1827581388850077,0.6198127707139863
Missouri,29137,Monroe County,3477,936,4483,2541,0.775596698639304,0.20878875752844078,0.5668079411108633
Missouri,29139,Montgomery County,4465,1208,5772,3257,0.7735620235620235,0.20928620928620928,0.5642758142758142
Missouri,29141,Morgan County,7442,1924,9487,5518,0.784441867819121,0.2028038368293454,0.5816380309897755
Missouri,29143,New Madrid County,5447,1748,7250,3699,0.7513103448275862,0.24110344827586208,0.5102068965517241
Missouri,29145,Newton County,22120,5818,28405,16302,0.7787361380038725,0.20482309452561168,0.5739130434782609
Missouri,29147,Nodaway County,6865,2853,9893,4012,0.6939249974729607,0.2883857272819165,0.40553927019104413
Missouri,29149,Oregon County,3847,823,4739,3024,0.8117746359991559,0.17366533023844694,0.638109305760709
Missouri,29151,Osage County,6425,1037,7539,5388,0.8522350444356015,0.1375513993898395,0.714683645045762
Missouri,29153,Ozark County,4064,752,4864,3312,0.8355263157894737,0.15460526315789475,0.680921052631579
Missouri,29155,Pemiscot County,4120,1560,5735,2560,0.7183958151700087,0.27201394943330426,0.44638186573670446
Missouri,29157,Perry County,7657,1664,9447,5993,0.8105218587911507,0.17614057372710915,0.6343812850640416
Missouri,29159,Pettis County,13854,4783,19097,9071,0.7254542598313871,0.2504581871498141,0.474996072681573
Missouri,29161,Phelps County,13480,5637,19568,7843,0.6888798037612428,0.28807236304170075,0.40080744071954205
Missouri,29163,Pike County,5863,1717,7695,4146,0.7619233268356075,0.22313190383365822,0.5387914230019493
Missouri,29165,Platte County,28917,27179,57270,1738,0.5049240440020953,0.4745765671381177,0.03034747686397765
Missouri,29167,Polk County,11850,2885,15064,8965,0.7866436537440255,0.19151619755708976,0.5951274561869357
Missouri,29169,Pulaski County,10329,3740,14414,6589,0.7165949771055918,0.2594699597613431,0.4571250173442487
Missouri,29171,Putnam County,1984,361,2361,1623,0.8403218975010589,0.15290131300296483,0.6874205844980941
Missouri,29173,Ralls County,4396,1205,5662,3191,0.7764040974920523,0.21282232426704345,0.5635817732250088
Missouri,29175,Randolph County,8018,2485,10744,5533,0.746276991809382,0.23129188384214444,0.5149851079672376
Missouri,29177,Ray County,8345,3109,11649,5236,0.7163705039059147,0.26688986179071167,0.44948064211520306
Missouri,29179,Reynolds County,2733,529,3298,2204,0.8286840509399637,0.16040024257125532,0.6682838083687084
Missouri,29181,Ripley County,4839,833,5717,4006,0.8464229490991779,0.1457057897498688,0.7007171593493091
Missouri,29183,St. Charles County,128389,89530,222017,38859,0.578284545778026,0.4032574082164879,0.1750271375615381
Missouri,29185,St. Clair County,3932,988,4974,2944,0.7905106554081223,0.19863289103337353,0.5918777643747487
Missouri,29186,Ste. Genevieve County,6630,2713,9484,3917,0.6990721214677351,0.2860607338675664,0.4130113876001687
Missouri,29187,St. Francois County,20511,7044,28001,13467,0.7325095532302418,0.2515624441984215,0.4809471090318203
Missouri,29189,St. Louis County,199493,328151,536446,-128658,0.37187899620837883,0.6117130149166925,-0.23983401870831367
Missouri,29195,Saline County,6451,2904,9519,3547,0.6776972371047378,0.30507406240151275,0.3726231747032251
Missouri,29197,Schuyler County,1606,373,2003,1233,0.8017973040439341,0.18622066899650525,0.6155766350474289
Missouri,29199,Scotland County,1560,388,1984,1172,0.7862903225806451,0.19556451612903225,0.5907258064516129
Missouri,29201,Scott County,13769,3753,17719,10016,0.7770754557254924,0.21180653535752583,0.5652689203679666
Missouri,29203,Shannon County,3165,706,3906,2459,0.8102918586789555,0.18074756784434204,0.6295442908346134
Missouri,29205,Shelby County,2700,592,3350,2108,0.8059701492537313,0.17671641791044776,0.6292537313432836
Missouri,29207,Stoddard County,11484,1819,13426,9665,0.8553552807984508,0.13548339043646657,0.7198718903619843
Missouri,29209,Stone County,14800,3506,18483,11294,0.8007358112860467,0.1896878212411405,0.6110479900449062
Missouri,29211,Sullivan County,1974,478,2471,1496,0.7988668555240793,0.19344394981788748,0.6054229057061918
Missouri,29213,Taney County,20508,5339,26288,15169,0.7801278149726111,0.20309646987218502,0.5770313451004261
Missouri,29215,Texas County,9478,1716,11315,7762,0.8376491383119753,0.1516570923552806,0.6859920459566947
Missouri,29217,Vernon County,7155,1903,9185,5252,0.778987479586282,0.20718562874251498,0.571801850843767
Missouri,29219,Warren County,13222,4769,18375,8453,0.7195646258503401,0.25953741496598637,0.4600272108843537
Missouri,29221,Washington County,8047,1804,9976,6243,0.806635926222935,0.18083400160384924,0.6258019246190858
Missouri,29223,Wayne County,4987,845,5878,4142,0.8484178291936033,0.14375637972099353,0.7046614494726098
Missouri,29225,Webster County,14880,3573,18779,11307,0.7923744608339102,0.19026572234943287,0.6021087384844773
Missouri,29227,Worth County,877,215,1107,662,0.7922312556458898,0.1942186088527552,0.5980126467931346
Missouri,29229,Wright County,7453,1168,8739,6285,0.8528435747797231,0.1336537361254148,0.7191898386543083
Missouri,29510,St. Louis city,21474,110089,133867,-88615,0.16041294717891638,0.8223759402989534,-0.661962993120037
Montana,30001,Beaverhead County,3923,1608,5661,2315,0.6929871047518106,0.2840487546369899,0.40893835011482066
Montana,30003,Big Horn County,2207,2491,4784,-284,0.4613294314381271,0.5206939799331104,-0.059364548494983294
Montana,30005,Blaine County,1469,1589,3117,-120,0.4712864934231633,0.5097850497273019,-0.038498556304138565
Montana,30007,Broadwater County,3173,835,4097,2338,0.7744691237490847,0.20380766414449597,0.5706614596045887
Montana,30009,Carbon County,4468,2421,7101,2047,0.6292071539219828,0.3409378960709759,0.2882692578510069
Montana,30011,Carter County,775,74,864,701,0.8969907407407407,0.08564814814814815,0.8113425925925926
Montana,30013,Cascade County,23315,15456,39885,7859,0.5845555973423593,0.387514103046258,0.1970414942961013
Montana,30015,Chouteau County,1891,991,2974,900,0.6358439811701412,0.3332212508406187,0.30262273032952247
Montana,30017,Custer County,4205,1514,5883,2691,0.7147713751487337,0.25735169131395547,0.4574196838347782
Montana,30019,Daniels County,799,195,1014,604,0.7879684418145957,0.19230769230769232,0.5956607495069034
Montana,30021,Dawson County,3758,962,4837,2796,0.77692784783957,0.19888360554062434,0.5780442422989457
Montana,30023,Deer Lodge County,2186,2562,4891,-376,0.44694336536495605,0.5238192598650583,-0.07687589450010224
Montana,30025,Fallon County,1375,172,1575,1203,0.873015873015873,0.10920634920634921,0.7638095238095238
Montana,30027,Fergus County,4869,1496,6531,3373,0.7455213596692697,0.2290613994794059,0.5164599601898638
Montana,30029,Flathead County,38321,20274,60258,18047,0.6359487536924557,0.33645325102061135,0.2994955026718444
Montana,30031,Gallatin County,31696,37044,71507,-5348,0.44325730348077813,0.5180471841917574,-0.0747898807109793
Montana,30033,Garfield County,764,41,813,723,0.939729397293973,0.05043050430504305,0.88929889298893
Montana,30035,Glacier County,1884,3610,5639,-1726,0.3341017910977124,0.6401844298634509,-0.30608263876573855
Montana,30037,Golden Valley County,414,78,503,336,0.8230616302186878,0.1550695825049702,0.6679920477137177
Montana,30039,Granite County,1419,638,2102,781,0.6750713606089439,0.30352045670789723,0.37155090390104667
Montana,30041,Hill County,3957,2981,7182,976,0.5509607351712615,0.41506544138123086,0.13589529379003068
Montana,30043,Jefferson County,5345,2625,8191,2720,0.6525454767427664,0.32047369063606396,0.33207178610670246
Montana,30045,Judith Basin County,1040,275,1344,765,0.7738095238095238,0.20461309523809523,0.5691964285714286
Montana,30047,Lake County,9322,6916,16626,2406,0.5606880789125466,0.41597497894863467,0.1447130999639119
Montana,30049,Lewis and Clark County,21409,19743,42485,1666,0.5039190302459692,0.4647051900670825,0.03921384017888668
Montana,30051,Liberty County,821,249,1083,572,0.7580794090489381,0.2299168975069252,0.5281625115420129
Montana,30053,Lincoln County,8672,2835,11747,5837,0.7382310377117562,0.2413382140120882,0.49689282369966803
Montana,30055,McCone County,956,155,1128,801,0.8475177304964538,0.1374113475177305,0.7101063829787233
Montana,30057,Madison County,4191,1771,6113,2420,0.6855880909537052,0.2897104531326681,0.39587763782103713
Montana,30059,Meagher County,833,258,1110,575,0.7504504504504504,0.23243243243243245,0.5180180180180181
Montana,30061,Mineral County,1828,686,2563,1142,0.7132266874756145,0.26765509168942647,0.445571595786188
Montana,30063,Missoula County,26347,43357,71986,-17010,0.3660017225571639,0.6022976689911927,-0.23629594643402885
Montana,30065,Musselshell County,2423,413,2881,2010,0.8410274210343631,0.1433530024297119,0.6976744186046512
Montana,30067,Park County,6025,5280,11618,745,0.5185918402478912,0.45446720605956276,0.06412463418832842
Montana,30069,Petroleum County,298,39,351,259,0.8490028490028491,0.1111111111111111,0.737891737891738
Montana,30071,Phillips County,1936,416,2386,1520,0.8113998323554066,0.17435037720033528,0.6370494551550713
Montana,30073,Pondera County,2031,903,2995,1128,0.6781302170283806,0.30150250417362273,0.3766277128547579
Montana,30075,Powder River County,970,154,1136,816,0.8538732394366197,0.13556338028169015,0.7183098591549296
Montana,30077,Powell County,2355,752,3195,1603,0.7370892018779343,0.2353677621283255,0.5017214397496088
Montana,30079,Prairie County,603,126,744,477,0.8104838709677419,0.1693548387096774,0.6411290322580645
Montana,30081,Ravalli County,19114,8763,28507,10351,0.6705019819693409,0.307398182902445,0.3631037990668958
Montana,30083,Richland County,4800,875,5798,3925,0.8278716798896171,0.15091410831321145,0.6769575715764056
Montana,30085,Roosevelt County,1996,1910,4028,86,0.4955312810327706,0.4741807348560079,0.021350546176762686
Montana,30087,Rosebud County,2486,1199,3784,1287,0.6569767441860465,0.3168604651162791,0.3401162790697674
Montana,30089,Sanders County,5660,1820,7652,3840,0.7396759017250392,0.23784631468897022,0.501829587036069
Montana,30091,Sheridan County,1403,574,2030,829,0.6911330049261084,0.2827586206896552,0.4083743842364532
Montana,30093,Silver Bow County,7745,10392,18827,-2647,0.41137727731449514,0.5519732299357306,-0.14059595262123548
Montana,30095,Stillwater County,4462,1156,5741,3306,0.7772165128026476,0.20135864831910816,0.5758578644835395
Montana,30097,Sweet Grass County,1840,549,2446,1291,0.7522485690923958,0.22444807849550286,0.5278004905968929
Montana,30099,Teton County,2608,1007,3695,1601,0.7058186738836265,0.27253044654939107,0.43328822733423544
Montana,30101,Toole County,1596,467,2123,1129,0.7517663683466792,0.21997173810645312,0.5317946302402261
Montana,30103,Treasure County,373,78,460,295,0.8108695652173913,0.16956521739130434,0.6413043478260869
Montana,30105,Valley County,3135,1030,4272,2105,0.7338483146067416,0.24110486891385768,0.4927434456928839
Montana,30107,Wheatland County,823,225,1068,598,0.7705992509363296,0.21067415730337077,0.5599250936329588
Montana,30109,Wibaux County,516,77,598,439,0.862876254180602,0.12876254180602006,0.7341137123745819
Montana,30111,Yellowstone County,50772,30679,83821,20093,0.6057193304780425,0.3660061321148638,0.23971319836317867
Nebraska,31001,Adams County,10085,4213,14653,5872,0.6882549648536136,0.28751791442025526,0.40073705043335833
Nebraska,31003,Antelope County,3093,452,3583,2641,0.8632430923806865,0.12615126988557074,0.7370918224951157
Nebraska,31005,Arthur County,260,21,285,239,0.9122807017543859,0.07368421052631578,0.8385964912280701
Nebraska,31007,Banner County,362,43,411,319,0.8807785888077859,0.10462287104622871,0.7761557177615572
Nebraska,31009,Blaine County,280,35,317,245,0.8832807570977917,0.11041009463722397,0.7728706624605678
Nebraska,31011,Boone County,2653,499,3226,2154,0.8223806571605704,0.15468071915685058,0.6676999380037199
Nebraska,31013,Box Butte County,4002,1051,5200,2951,0.7696153846153846,0.2021153846153846,0.5675
Nebraska,31015,Boyd County,1010,135,1155,875,0.8744588744588745,0.11688311688311688,0.7575757575757576
Nebraska,31017,Brown County,1470,191,1684,1279,0.8729216152019003,0.11342042755344418,0.7595011876484561
Nebraska,31019,Buffalo County,16640,6350,23711,10290,0.7017839821180043,0.26780819029142594,0.43397579182657836
Nebraska,31021,Burt County,2580,1063,3739,1517,0.6900240706071142,0.28430061513773736,0.4057234554693769
Nebraska,31023,Butler County,3542,873,4518,2669,0.783975210270031,0.19322709163346613,0.5907481186365648
Nebraska,31025,Cass County,10121,4737,15326,5384,0.6603810518073862,0.30908260472399846,0.3512984470833877
Nebraska,31027,Cedar County,4174,725,5015,3449,0.8323030907278165,0.14456630109670987,0.6877367896311066
Nebraska,31029,Chase County,1740,226,2000,1514,0.87,0.113,0.757
Nebraska,31031,Cherry County,2844,373,3269,2471,0.8699908228816152,0.11410217191801775,0.7558886509635975
Nebraska,31033,Cheyenne County,3813,855,4776,2958,0.7983668341708543,0.17902010050251257,0.6193467336683417
Nebraska,31035,Clay County,2848,632,3570,2216,0.7977591036414566,0.17703081232492998,0.6207282913165266
Nebraska,31037,Colfax County,2636,1025,3726,1611,0.7074610842726785,0.27509393451422437,0.43236714975845414
Nebraska,31039,Cuming County,3507,870,4459,2637,0.7864992150706437,0.19511101143754206,0.5913882036331016
Nebraska,31041,Custer County,5090,786,6010,4304,0.8469217970049917,0.1307820299500832,0.7161397670549086
Nebraska,31043,Dakota County,3926,2744,6817,1182,0.5759131582807686,0.40252310400469415,0.17339005427607446
Nebraska,31045,Dawes County,2931,1082,4151,1849,0.706094916887497,0.26066008190797396,0.4454348349795231
Nebraska,31047,Dawson County,6524,2497,9191,4027,0.7098248286367098,0.27167881623327167,0.43814601240343815
Nebraska,31049,Deuel County,871,141,1034,730,0.8423597678916828,0.13636363636363635,0.7059961315280464
Nebraska,31051,Dixon County,2335,651,3094,1684,0.7546864899806076,0.21040723981900453,0.5442792501616031
Nebraska,31053,Dodge County,10984,5544,16938,5440,0.6484827016176644,0.3273113708820404,0.32117133073562404
Nebraska,31055,Douglas County,119159,150350,276540,-31191,0.43089245678744487,0.5436826498879005,-0.11279019310045563
Nebraska,31057,Dundy County,883,105,1003,778,0.8803589232303091,0.10468594217347957,0.7756729810568295
Nebraska,31059,Fillmore County,2359,693,3148,1666,0.7493646759847522,0.22013977128335452,0.5292249047013977
Nebraska,31061,Franklin County,1437,276,1728,1161,0.8315972222222222,0.1597222222222222,0.671875
Nebraska,31063,Frontier County,1229,189,1446,1040,0.8499308437067773,0.13070539419087138,0.719225449515906
Nebraska,31065,Furnas County,2163,399,2602,1764,0.8312836279784781,0.1533435818601076,0.6779400461183704
Nebraska,31067,Gage County,7445,3385,11119,4060,0.6695746020325569,0.30443385196510475,0.36514075006745217
Nebraska,31069,Garden County,1016,161,1200,855,0.8466666666666667,0.13416666666666666,0.7125
Nebraska,31071,Garfield County,933,133,1076,800,0.8671003717472119,0.12360594795539033,0.7434944237918215
Nebraska,31073,Gosper County,893,215,1121,678,0.7966101694915254,0.19179304192685104,0.6048171275646743
Nebraska,31075,Grant County,375,20,402,355,0.9328358208955224,0.04975124378109453,0.8830845771144279
Nebraska,31077,Greeley County,1016,229,1259,787,0.806989674344718,0.181890389197776,0.625099285146942
Nebraska,31079,Hall County,16189,7681,24450,8508,0.6621267893660532,0.31415132924335376,0.3479754601226994
Nebraska,31081,Hamilton County,4309,1118,5566,3191,0.7741645706072584,0.20086237872799137,0.573302191879267
Nebraska,31083,Harlan County,1615,282,1934,1333,0.8350568769389866,0.14581178903826267,0.6892450879007239
Nebraska,31085,Hayes County,494,34,536,460,0.9216417910447762,0.06343283582089553,0.8582089552238806
Nebraska,31087,Hitchcock County,1264,175,1470,1089,0.8598639455782313,0.11904761904761904,0.7408163265306122
Nebraska,31089,Holt County,4769,686,5550,4083,0.8592792792792793,0.1236036036036036,0.7356756756756757
Nebraska,31091,Hooker County,376,59,442,317,0.8506787330316742,0.1334841628959276,0.7171945701357466
Nebraska,31093,Howard County,2786,648,3511,2138,0.7935061236115067,0.18456280262033609,0.6089433209911707
Nebraska,31095,Jefferson County,2616,1016,3730,1600,0.7013404825737265,0.27238605898123325,0.42895442359249325
Nebraska,31097,Johnson County,1518,647,2233,871,0.6798029556650246,0.2897447380206001,0.3900582176444245
Nebraska,31099,Kearney County,2822,701,3617,2121,0.7802045894387614,0.19380702239424938,0.586397567044512
Nebraska,31101,Keith County,3544,763,4369,2781,0.8111696040283818,0.17463950560769054,0.6365300984206912
Nebraska,31103,Keya Paha County,476,49,530,427,0.8981132075471698,0.09245283018867924,0.8056603773584906
Nebraska,31105,Kimball County,1563,268,1877,1295,0.8327117741076185,0.1427810335641982,0.6899307405434203
Nebraska,31107,Knox County,3721,905,4708,2816,0.79035683942226,0.19222599830076464,0.5981308411214954
Nebraska,31109,Lancaster County,70092,82293,157215,-12201,0.445835321057151,0.5234424196164488,-0.07760709855929776
Nebraska,31111,Lincoln County,13071,3692,17163,9379,0.7615801433315854,0.21511390782497233,0.5464662355066131
Nebraska,31113,Logan County,407,38,450,369,0.9044444444444445,0.08444444444444445,0.8200000000000001
Nebraska,31115,Loup County,370,75,454,295,0.8149779735682819,0.16519823788546256,0.6497797356828194
Nebraska,31117,McPherson County,275,17,302,258,0.9105960264900662,0.056291390728476824,0.8543046357615894
Nebraska,31119,Madison County,11940,3478,15819,8462,0.7547885454200645,0.21986219103609583,0.5349263543839686
Nebraska,31121,Merrick County,3419,743,4282,2676,0.7984586641756188,0.17351704810836058,0.6249416160672583
Nebraska,31123,Morrill County,2113,386,2558,1727,0.8260359655981235,0.15089913995308835,0.6751368256450352
Nebraska,31125,Nance County,1437,359,1832,1078,0.7843886462882096,0.19596069868995633,0.5884279475982532
Nebraska,31127,Nemaha County,2428,921,3432,1507,0.7074592074592074,0.26835664335664333,0.4391025641025641
Nebraska,31129,Nuckolls County,1857,409,2305,1448,0.8056399132321042,0.17744034707158352,0.6281995661605206
Nebraska,31131,Otoe County,5649,2490,8355,3159,0.6761220825852783,0.2980251346499102,0.3780969479353681
Nebraska,31133,Pawnee County,1071,322,1429,749,0.7494751574527642,0.22533240027991602,0.5241427571728481
Nebraska,31135,Perkins County,1321,199,1545,1122,0.8550161812297734,0.12880258899676375,0.7262135922330096
Nebraska,31137,Phelps County,4157,752,5021,3405,0.8279227245568612,0.14977096195976897,0.6781517625970923
Nebraska,31139,Pierce County,3462,480,4012,2982,0.8629112662013958,0.11964107676969092,0.7432701894317049
Nebraska,31141,Platte County,12186,3260,15721,8926,0.7751415304369951,0.20736594364226194,0.5677755867947332
Nebraska,31143,Polk County,2291,530,2887,1761,0.7935573259438864,0.1835815725666782,0.6099757533772082
Nebraska,31145,Red Willow County,4525,811,5470,3714,0.8272394881170019,0.1482632541133455,0.6789762340036564
Nebraska,31147,Richardson County,3073,996,4134,2077,0.743347847121432,0.2409288824383164,0.5024189646831156
Nebraska,31149,Rock County,744,84,842,660,0.8836104513064132,0.0997624703087886,0.7838479809976246
Nebraska,31151,Saline County,3631,1986,5780,1645,0.6282006920415225,0.343598615916955,0.2846020761245675
Nebraska,31153,Sarpy County,51979,41206,96193,10773,0.5403615647708253,0.4283679685632011,0.11199359620762422
Nebraska,31155,Saunders County,9108,3331,12786,5777,0.7123416236508682,0.26051931800406697,0.4518223056468012
Nebraska,31157,Scotts Bluff County,10952,4196,15524,6756,0.7054882762174697,0.270291162071631,0.43519711414583867
Nebraska,31159,Seward County,6490,2438,9199,4052,0.7055114686378954,0.2650288074790738,0.44048266115882156
Nebraska,31161,Sheridan County,2292,340,2684,1952,0.8539493293591655,0.12667660208643816,0.7272727272727273
Nebraska,31163,Sherman County,1322,343,1700,979,0.7776470588235294,0.20176470588235293,0.5758823529411764
Nebraska,31165,Sioux County,642,72,731,570,0.8782489740082079,0.09849521203830369,0.7797537619699042
Nebraska,31167,Stanton County,2561,532,3165,2029,0.8091627172195892,0.16808846761453397,0.6410742496050552
Nebraska,31169,Thayer County,2308,624,2989,1684,0.7721646035463365,0.20876547340247575,0.5633991301438608
Nebraska,31171,Thomas County,377,45,427,332,0.882903981264637,0.1053864168618267,0.7775175644028103
Nebraska,31173,Thurston County,1180,1122,2379,58,0.49600672551492225,0.47162673392181587,0.024379991593106387
Nebraska,31175,Valley County,1901,412,2344,1489,0.8110068259385665,0.1757679180887372,0.6352389078498293
Nebraska,31177,Washington County,8583,3554,12467,5029,0.6884575278735863,0.2850725916419347,0.40338493623165156
Nebraska,31179,Wayne County,3055,1022,4218,2033,0.7242769084874348,0.2422949265054528,0.48198198198198194
Nebraska,31181,Webster County,1511,335,1876,1176,0.8054371002132196,0.17857142857142858,0.626865671641791
Nebraska,31183,Wheeler County,438,59,503,379,0.8707753479125249,0.1172962226640159,0.7534791252485089
Nebraska,31185,York County,5337,1630,7161,3707,0.7452869710934227,0.22762184052506634,0.5176651305683564
Nevada,32001,Churchill County,9372,3051,12890,6321,0.7270752521334368,0.23669511249030256,0.49038013964313426
Nevada,32003,Clark County,430930,521852,972510,-90922,0.4431111248213386,0.5366032225889709,-0.09349209776763229
Nevada,32005,Douglas County,21630,11571,34125,10059,0.6338461538461538,0.33907692307692305,0.2947692307692308
Nevada,32007,Elko County,16741,4557,21967,12184,0.7620976919925343,0.2074475349387718,0.5546501570537625
Nevada,32009,Esmeralda County,400,74,487,326,0.8213552361396304,0.15195071868583163,0.6694045174537987
Nevada,32011,Eureka County,895,105,1017,790,0.880039331366765,0.10324483775811209,0.7767944936086529
Nevada,32013,Humboldt County,5877,1689,7771,4188,0.7562733238965385,0.21734654484622315,0.5389267790503153
Nevada,32015,Lander County,2198,496,2765,1702,0.7949367088607595,0.17938517179023508,0.6155515370705245
Nevada,32017,Lincoln County,2067,330,2446,1737,0.8450531479967294,0.1349141455437449,0.7101390024529844
Nevada,32019,Lyon County,20914,8473,30238,12441,0.6916462729016469,0.28021033137112245,0.4114359415305245
Nevada,32021,Mineral County,1423,829,2335,594,0.6094218415417559,0.3550321199143469,0.254389721627409
Nevada,32023,Nye County,17528,7288,25378,10240,0.6906769642997872,0.28717787059657973,0.40349909370320747
Nevada,32027,Pershing County,1731,547,2320,1184,0.7461206896551724,0.23577586206896553,0.5103448275862069
Nevada,32029,Storey County,1908,902,2877,1006,0.6631908237747653,0.313521028849496,0.34966979492526934
Nevada,32031,Washoe County,116760,128128,252142,-11368,0.4630723957135265,0.5081581013873135,-0.04508570567378706
Nevada,32033,White Pine County,3403,859,4369,2544,0.7788967727168689,0.1966124971389334,0.5822842755779355
Nevada,32510,Carson City,16113,12735,29739,3378,0.5418137798849995,0.4282255623928175,0.11358821749218195
New Hampshire,33001,Belknap County,20899,16894,38453,4005,0.5434946558135906,0.43934153382050817,0.10415312199308241
New Hampshire,33003,Carroll County,16150,16649,33272,-499,0.4853931233469584,0.500390718922818,-0.014997595575859557
New Hampshire,33005,Cheshire County,17892,25506,44206,-7614,0.4047414378138714,0.5769805003845632,-0.17223906257069177
New Hampshire,33007,Coos County,8617,7640,16528,977,0.5213576960309777,0.46224588576960307,0.05911181026137463
New Hampshire,33009,Grafton County,19905,33180,53989,-13275,0.3686862138583786,0.6145696345551872,-0.24588342069680863
New Hampshire,33011,Hillsborough County,104625,122344,231040,-17719,0.45284366343490307,0.5295360110803324,-0.07669234764542937
New Hampshire,33013,Merrimack County,39711,48533,89887,-8822,0.441788022739662,0.5399334720259882,-0.09814544928632618
New Hampshire,33015,Rockingham County,95858,100064,198943,-4206,0.48183650593386046,0.5029782399983915,-0.02114173406453107
New Hampshire,33017,Strafford County,30489,41721,73729,-11232,0.41352791981445564,0.565869603548129,-0.15234168373367335
New Hampshire,33019,Sullivan County,11508,12390,24383,-882,0.47196817454784074,0.5081409178526022,-0.036172743304761446
New Jersey,34001,Atlantic County,64438,73808,140441,-9370,0.45882612627366653,0.5255445347156457,-0.06671840844197913
New Jersey,34003,Bergen County,204417,285967,497460,-81550,0.4109214811241105,0.574854259638966,-0.1639327785148555
New Jersey,34005,Burlington County,103345,154595,262650,-51250,0.393470397867885,0.5885969921949362,-0.1951265943270512
New Jersey,34007,Camden County,86207,175065,265599,-88858,0.3245757702400988,0.6591327527588583,-0.3345569825187595
New Jersey,34009,Cape May County,33158,23941,57933,9217,0.5723508190495917,0.4132532408126629,0.15909757823692883
New Jersey,34011,Cumberland County,28952,32742,62575,-3790,0.4626767878545745,0.5232441070715141,-0.06056731921693964
New Jersey,34013,Essex County,75475,266820,345311,-191345,0.2185710851956642,0.7726947592170537,-0.5541236740213895
New Jersey,34015,Gloucester County,83340,86702,173453,-3362,0.48047597908367107,0.49985875136204044,-0.019382772278369376
New Jersey,34017,Hudson County,65698,181452,250458,-115754,0.26231144543196866,0.7244807512636849,-0.4621693058317163
New Jersey,34019,Hunterdon County,43153,39457,84673,3696,0.5096429794621662,0.46599270133336484,0.043650278128801345
New Jersey,34021,Mercer County,51641,122532,177223,-70891,0.2913899437431936,0.6914001004384307,-0.4000101566952371
New Jersey,34023,Middlesex County,143467,226250,375692,-82783,0.38187398187877303,0.6022220329418779,-0.2203480510631049
New Jersey,34025,Monmouth County,191808,181291,378390,10517,0.5069055736145247,0.47911149871825365,0.02779407489627106
New Jersey,34027,Morris County,141134,153881,300917,-12747,0.46901305011016325,0.5113735681267592,-0.042360518016595905
New Jersey,34029,Ocean County,217740,119456,342746,98284,0.6352809369037129,0.3485263139467711,0.2867546229569418
New Jersey,34031,Passaic County,92009,129097,224330,-37088,0.41015022511478627,0.5754780903133776,-0.16532786519859133
New Jersey,34033,Salem County,18827,14479,34042,4348,0.5530521120968216,0.4253275365724693,0.1277245755243523
New Jersey,34035,Somerset County,71996,111173,186891,-39177,0.38522989336030095,0.5948547549106163,-0.2096248615503154
New Jersey,34037,Sussex County,51698,34481,88352,17217,0.5851367258239768,0.3902684715682724,0.19486825425570442
New Jersey,34039,Union County,80002,170245,254041,-90243,0.3149176707696789,0.6701477320589984,-0.35523006128931944
New Jersey,34041,Warren County,34769,24901,61057,9868,0.5694514961429484,0.4078320258119462,0.1616194703310022
New Mexico,35001,Bernalillo County,116135,193757,317590,-77622,0.3656758714065304,0.6100853301426368,-0.24440945873610637
New Mexico,35003,Catron County,1698,595,2326,1103,0.7300085984522786,0.25580395528804817,0.47420464316423044
New Mexico,35005,Chaves County,15656,6381,22443,9275,0.6975894488259146,0.2843202780376955,0.41326917078821906
New Mexico,35006,Cibola County,3975,4745,8903,-770,0.4464787150398742,0.5329664158148939,-0.08648770077501972
New Mexico,35007,Colfax County,3271,2611,6016,660,0.543716755319149,0.4340093085106383,0.10970744680851069
New Mexico,35009,Curry County,10444,4307,15101,6137,0.691609827163764,0.2852128998079597,0.40639692735580424
New Mexico,35011,De Baca County,656,231,901,425,0.7280799112097669,0.2563817980022198,0.4716981132075471
New Mexico,35013,Doña Ana County,32802,47957,82641,-15155,0.3969216248593313,0.5803051753972,-0.18338355053786864
New Mexico,35015,Eddy County,17454,5424,23222,12030,0.7516148479889759,0.23357161312548447,0.5180432348634915
New Mexico,35017,Grant County,6553,7590,14435,-1037,0.45396605472809143,0.5258053342570143,-0.07183927952892283
New Mexico,35019,Guadalupe County,917,1234,2189,-317,0.4189127455459114,0.5637277295568753,-0.14481498401096393
New Mexico,35021,Harding County,319,179,505,140,0.6316831683168317,0.35445544554455444,0.27722772277227725
New Mexico,35023,Hidalgo County,1120,823,1974,297,0.5673758865248227,0.41691995947315097,0.15045592705167177
New Mexico,35025,Lea County,16531,4061,20918,12470,0.7902763170475189,0.1941390190266756,0.5961372980208433
New Mexico,35027,Lincoln County,6942,3194,10306,3748,0.6735882010479333,0.30991655346400154,0.3636716475839317
New Mexico,35028,Los Alamos County,4278,7554,12293,-3276,0.348002928495892,0.6144960546652567,-0.2664931261693647
New Mexico,35029,Luna County,4408,3563,8103,845,0.543996050845366,0.43971368628902874,0.10428236455633721
New Mexico,35031,McKinley County,7801,18029,26486,-10228,0.29453296080948427,0.6806992373329306,-0.3861662765234463
New Mexico,35033,Mora County,903,1745,2686,-842,0.3361876396128071,0.6496649292628444,-0.31347728965003724
New Mexico,35035,Otero County,14521,8485,23571,6036,0.6160536252174282,0.3599762419922786,0.2560773832251496
New Mexico,35037,Quay County,2634,1170,3873,1464,0.6800929512006196,0.3020914020139427,0.37800154918667694
New Mexico,35039,Rio Arriba County,5408,10990,16628,-5582,0.3252345441424104,0.6609333654077459,-0.33569882126533557
New Mexico,35041,Roosevelt County,4634,1802,6608,2832,0.701271186440678,0.2726997578692494,0.4285714285714286
New Mexico,35043,Sandoval County,34174,40588,76562,-6414,0.4463572007000862,0.5301324416812518,-0.08377524098116562
New Mexico,35045,San Juan County,32874,18083,52294,14791,0.6286380846751062,0.34579492867250544,0.28284315600260074
New Mexico,35047,San Miguel County,3421,7888,11531,-4467,0.2966785187754748,0.6840690313069118,-0.38739051253143697
New Mexico,35049,Santa Fe County,18329,62530,82227,-44201,0.2229073175477641,0.7604558113515025,-0.5375484938037385
New Mexico,35051,Sierra County,3542,2265,5945,1277,0.5957947855340623,0.3809924306139613,0.21480235492010097
New Mexico,35053,Socorro County,3255,3722,7160,-467,0.454608938547486,0.5198324022346369,-0.06522346368715087
New Mexico,35055,Taos County,3715,13121,17181,-9406,0.21622722775158607,0.7636924509632734,-0.5474652232116873
New Mexico,35057,Torrance County,4772,2344,7281,2428,0.6554044774069496,0.3219338003021563,0.33347067710479333
New Mexico,35059,Union County,1388,383,1789,1005,0.7758524315259921,0.21408608160983789,0.5617663499161543
New Mexico,35061,Valencia County,17364,14263,32277,3101,0.537968212659169,0.4418936084518388,0.09607460420733027
New York,36001,Albany County,51081,99474,154101,-48393,0.3314774076741877,0.6455117098526291,-0.31403430217844136
New York,36003,Allegany County,14135,6048,20782,8087,0.6801559041478202,0.2910210759310942,0.389134828216726
New York,36005,Bronx County,67740,355374,425715,-287634,0.1591205383883584,0.8347697403192277,-0.6756492019308693
New York,36007,Broome County,43800,47010,92794,-3210,0.4720132767204776,0.5066060305623208,-0.03459275384184318
New York,36009,Cattaraugus County,22155,11879,34845,10276,0.6358157554885924,0.34090974314822786,0.2949060123403645
New York,36011,Cayuga County,19512,16149,36421,3363,0.5357348782295929,0.44339803959254276,0.09233683863705011
New York,36013,Chautauqua County,34853,23087,59304,11766,0.5877006610009443,0.3892992041009038,0.19840145690004052
New York,36015,Chemung County,21922,16636,39410,5286,0.5562547576757169,0.42212636386703883,0.13412839380867803
New York,36017,Chenango County,13482,8290,22282,5192,0.6050623821919038,0.372049187685127,0.23301319450677677
New York,36019,Clinton County,16514,18364,35437,-1850,0.4660101024353077,0.5182154245562548,-0.052205322120947084
New York,36021,Columbia County,14464,20386,35522,-5922,0.40718428016440517,0.5738978661111424,-0.16671358594673719
New York,36023,Cortland County,10789,10369,21678,420,0.49769351416182306,0.47831903312113666,0.019374481040686398
New York,36025,Delaware County,13387,9143,23025,4244,0.5814115092290988,0.3970901194353963,0.1843213897937025
New York,36027,Dutchess County,66872,81443,151122,-14571,0.44250340784267017,0.5389221953123966,-0.09641878746972643
New York,36029,Erie County,197527,267174,473021,-69647,0.41758611139885965,0.564824817502817,-0.14723870610395734
New York,36031,Essex County,8976,9947,19259,-971,0.46606781245132145,0.5164857988472922,-0.050417986395970726
New York,36033,Franklin County,9668,9253,19268,415,0.5017645837658293,0.4802262819182064,0.021538301847622954
New York,36035,Fulton County,15378,7931,23744,7447,0.6476583557951483,0.33402122641509435,0.31363712938005395
New York,36037,Genesee County,18876,9625,29217,9251,0.6460622240476435,0.32943149536228905,0.3166307286853544
New York,36039,Greene County,14271,10346,25194,3925,0.5664443915217909,0.4106533301579741,0.15579106136381682
New York,36041,Hamilton County,2225,1178,3460,1047,0.6430635838150289,0.34046242774566476,0.30260115606936416
New York,36043,Herkimer County,18870,9937,29319,8933,0.6436099457689552,0.3389269756812988,0.30468297008765644
New York,36045,Jefferson County,25629,17307,43848,8322,0.5844964422550629,0.3947044334975369,0.189792008757526
New York,36047,Kings County,202772,703310,913246,-500538,0.22203436970980436,0.7701210845708604,-0.548086714861056
New York,36049,Lewis County,8894,3824,12944,5070,0.6871137206427689,0.2954264524103832,0.3916872682323857
New York,36051,Livingston County,18182,12477,31401,5705,0.5790261456641508,0.39734403362950227,0.1816821120346485
New York,36053,Madison County,18408,14807,34038,3601,0.5408073329807862,0.43501380809683293,0.10579352488395327
New York,36055,Monroe County,145661,225746,380983,-80085,0.38232939527485477,0.5925356249491447,-0.21020622967428992
New York,36057,Montgomery County,12745,7977,21134,4768,0.6030566859089619,0.37744866092552287,0.22560802498343902
New York,36059,Nassau County,326716,396504,732756,-69788,0.445872841709928,0.5411132764521888,-0.09524043474226074
New York,36061,New York County,85185,603040,694904,-517855,0.12258527796645292,0.86780332247332,-0.7452180445068671
New York,36063,Niagara County,56068,46029,104080,10039,0.5387009992313605,0.44224634896233667,0.09645465026902383
New York,36065,Oneida County,57180,41567,100746,15613,0.5675659579536656,0.41259206320846487,0.15497389474520074
New York,36067,Onondaga County,90619,138894,234735,-48275,0.38604809678999724,0.5917055402901144,-0.2056574435001171
New York,36069,Ontario County,29039,29025,59674,14,0.48662734189094076,0.4863927338539397,0.00023460803700103838
New York,36071,Orange County,84996,84684,172099,312,0.4938785234080384,0.49206561339694016,0.0018129100110982344
New York,36073,Orleans County,12126,5587,18154,6539,0.6679519665087584,0.30775586647570785,0.3601961000330506
New York,36075,Oswego County,32138,21143,54491,10995,0.5897854691600448,0.3880090290139656,0.2017764401460792
New York,36077,Otsego County,14382,12975,28008,1407,0.5134961439588689,0.4632604970008569,0.05023564695801197
New York,36079,Putnam County,29283,24953,54989,4330,0.5325246867555329,0.4537816654239939,0.07874302133153899
New York,36081,Queens County,212665,569038,787860,-356373,0.26992739826872797,0.7222577615312366,-0.4523303632625086
New York,36083,Rensselaer County,36500,40969,79409,-4469,0.4596456321071919,0.5159238877205354,-0.05627825561334354
New York,36085,Richmond County,123320,90997,216153,32323,0.5705218063131208,0.4209842102584743,0.14953759605464645
New York,36087,Rockland County,73186,75802,150369,-2616,0.48670936163703954,0.5041065645179525,-0.01739720288091301
New York,36089,St. Lawrence County,24608,19361,44907,5247,0.5479769300999844,0.4311354577237402,0.1168414723762442
New York,36091,Saratoga County,61305,68471,132655,-7166,0.46213863028155744,0.5161584561456409,-0.05401982586408349
New York,36093,Schenectady County,30741,42465,74826,-11724,0.41083313286825435,0.5675166386015557,-0.1566835057333013
New York,36095,Schoharie County,9903,5345,15710,4558,0.6303628262253341,0.3402291534054742,0.2901336728198599
New York,36097,Schuyler County,5621,3903,9766,1718,0.57556829817735,0.39965185336883063,0.17591644480851937
New York,36099,Seneca County,8329,6914,15630,1415,0.5328854766474728,0.44235444657709533,0.09053103007037744
New York,36101,Steuben County,29474,15790,46178,13684,0.6382693057300013,0.3419377192602538,0.2963315864697475
New York,36103,Suffolk County,381253,381021,771541,232,0.4941448348175923,0.493844137900643,0.00030069691694928347
New York,36105,Sullivan County,18665,15489,34647,3176,0.5387190810171155,0.4470516927872543,0.0916673882298612
New York,36107,Tioga County,14791,9634,25044,5157,0.5906005430442421,0.3846829579939307,0.20591758505031144
New York,36109,Tompkins County,11096,33619,45735,-22523,0.24261506504864983,0.7350825407237346,-0.49246747567508475
New York,36111,Ulster County,37590,57970,97420,-20380,0.38585506056251284,0.5950523506466845,-0.20919729008417165
New York,36113,Warren County,17699,17642,36131,57,0.4898563560377515,0.48827876338877974,0.0015775926489717818
New York,36115,Washington County,15941,11565,28138,4376,0.5665292487028218,0.41101002203425974,0.1555192266685621
New York,36117,Wayne County,26204,17456,44714,8748,0.5860356935188085,0.3903922708771302,0.19564342264167828
New York,36119,Westchester County,144713,312371,462122,-167658,0.3131489087297294,0.6759492082177434,-0.362800299488014
New York,36121,Wyoming County,13898,5073,19399,8825,0.7164286818908191,0.2615083251714006,0.4549203567194185
New York,36123,Yates County,6208,4219,10701,1989,0.5801326978787029,0.3942622184842538,0.18587047939444912
North Carolina,37001,Alamance County,46056,38825,86091,7231,0.5349688120709482,0.4509762925276742,0.08399251954327397
North Carolina,37003,Alexander County,15888,4145,20236,11743,0.7851354022534097,0.2048329709428741,0.5803024313105356
North Carolina,37005,Alleghany County,4527,1486,6076,3041,0.7450625411454904,0.2445687952600395,0.5004937458854509
North Carolina,37007,Anson County,5321,5789,11194,-468,0.4753439342504913,0.5171520457387886,-0.04180811148829727
North Carolina,37009,Ashe County,11451,4164,15814,7287,0.7241052232199318,0.26331099026179333,0.46079423295813843
North Carolina,37011,Avery County,7172,2191,9458,4981,0.7582998519771622,0.23165574117149504,0.5266441108056672
North Carolina,37013,Beaufort County,16437,9633,26315,6804,0.6246247387421623,0.36606498194945847,0.2585597567927038
North Carolina,37015,Bertie County,3817,5939,9815,-2122,0.3888945491594498,0.6050942435048395,-0.21619969434538971
North Carolina,37017,Bladen County,9676,7326,17125,2350,0.5650218978102189,0.4277956204379562,0.13722627737226273
North Carolina,37019,Brunswick County,55850,33310,90175,22540,0.6193512614360965,0.3693928472414749,0.24995841419462161
North Carolina,37021,Buncombe County,62412,96515,161569,-34103,0.3862869733674158,0.5973608798717576,-0.21107390650434177
North Carolina,37023,Burke County,31019,13118,44602,17901,0.6954620869019327,0.29411237164252724,0.40134971525940544
North Carolina,37025,Cabarrus County,63237,52162,117227,11075,0.539440572564341,0.44496575021112883,0.09447482235321214
North Carolina,37027,Caldwell County,32119,10245,42829,21874,0.7499357911695347,0.23920707931541713,0.5107287118541175
North Carolina,37029,Camden County,4312,1537,5953,2775,0.7243406685704686,0.2581891483285738,0.4661515202418948
North Carolina,37031,Carteret County,30028,12093,42695,17935,0.7033142054104696,0.283241597376742,0.42007260803372765
North Carolina,37033,Caswell County,7089,4860,12051,2229,0.5882499377645009,0.4032860343539955,0.18496390341050534
North Carolina,37035,Catawba County,56588,25689,83425,30899,0.6783098591549296,0.30792927779442614,0.37038058136050345
North Carolina,37037,Chatham County,21186,26787,48599,-5601,0.43593489577974853,0.5511841807444597,-0.11524928496471121
North Carolina,37039,Cherokee County,12628,3583,16423,9045,0.768921634293369,0.2181696401388297,0.5507519941545393
North Carolina,37041,Chowan County,4471,3247,7784,1224,0.5743833504624871,0.4171377183967112,0.1572456320657759
North Carolina,37043,Clay County,5112,1699,6893,3413,0.7416219352966777,0.24648193819817205,0.4951399970985057
North Carolina,37045,Cleveland County,33798,16955,51308,16843,0.6587276837920012,0.33045528962345055,0.32827239416855064
North Carolina,37047,Columbus County,16832,9446,26446,7386,0.6364667624593511,0.35718067004461923,0.27928609241473185
North Carolina,37049,Craven County,31032,21148,53065,9884,0.5847922359370583,0.39853010458871196,0.18626213134834635
North Carolina,37051,Cumberland County,60032,84469,147150,-24437,0.40796466190961606,0.5740332993544003,-0.16606863744478423
North Carolina,37053,Currituck County,11657,4195,16147,7462,0.7219297702359572,0.2598005821514833,0.4621291880844739
North Carolina,37055,Dare County,13938,9936,24232,4002,0.5751898316275998,0.41003631561571474,0.1651535160118851
North Carolina,37057,Davidson County,64658,22636,88514,42022,0.7304833133741555,0.25573355627358385,0.47474975710057166
North Carolina,37059,Davie County,18228,6713,25311,11515,0.7201611947374659,0.26522065505116355,0.4549405396863023
North Carolina,37061,Duplin County,13793,8767,22715,5026,0.6072198987453225,0.38595641646489104,0.2212634822804314
North Carolina,37063,Durham County,32459,144688,179914,-112229,0.1804139755661038,0.804206454194782,-0.6237924786286781
North Carolina,37065,Edgecombe County,9206,16089,25477,-6883,0.36134552733838365,0.6315107744239903,-0.27016524708560663
North Carolina,37067,Forsyth County,85064,113033,201270,-27969,0.4226362597505838,0.561598847319521,-0.13896258756893726
North Carolina,37069,Franklin County,20901,15879,37351,5022,0.5595834114213809,0.42512917994163474,0.13445423147974617
North Carolina,37071,Gaston County,73033,40959,115498,32074,0.6323312957800135,0.3546295173942406,0.27770177838577287
North Carolina,37073,Gates County,3367,2546,5971,821,0.5638921453692849,0.426394238820968,0.1374979065483169
North Carolina,37075,Graham County,3710,905,4665,2805,0.7952840300107181,0.1939978563772776,0.6012861736334405
North Carolina,37077,Granville County,16647,14565,31598,2082,0.52683714159124,0.4609468953731249,0.06589024621811507
North Carolina,37079,Greene County,4874,3832,8753,1042,0.5568376556609163,0.4377927567691077,0.11904489889180853
North Carolina,37081,Guilford County,107294,173086,284486,-65792,0.3771503694382149,0.6084165828898435,-0.23126621345162857
North Carolina,37083,Halifax County,10080,15545,25759,-5465,0.3913195388019721,0.6034783959004619,-0.2121588570984898
North Carolina,37085,Harnett County,35177,22093,58293,13084,0.6034515293431458,0.37899919372823493,0.2244523356149109
North Carolina,37087,Haywood County,22834,13144,36542,9690,0.6248700125882546,0.3596956926276613,0.26517431996059326
North Carolina,37089,Henderson County,40032,27211,68371,12821,0.5855114010326016,0.39799037603662374,0.18752102499597784
North Carolina,37091,Hertford County,3479,7097,10634,-3618,0.3271581719014482,0.6673876246003385,-0.3402294526988903
North Carolina,37093,Hoke County,9453,11804,21639,-2351,0.4368501317066408,0.5454965571421969,-0.10864642543555614
North Carolina,37095,Hyde County,1418,1046,2492,372,0.5690208667736758,0.41974317817014445,0.14927768860353136
North Carolina,37097,Iredell County,67010,33888,102371,33122,0.6545799103261666,0.3310312490842133,0.3235486612419533
North Carolina,37099,Jackson County,11356,9591,21428,1765,0.5299607989546388,0.44759193578495426,0.0823688631696845
North Carolina,37101,Johnston County,68353,41257,111357,27096,0.6138186193952783,0.37049309877241665,0.2433255206228616
North Carolina,37103,Jones County,3280,2197,5525,1083,0.5936651583710407,0.3976470588235294,0.19601809954751132
North Carolina,37105,Lee County,16469,12143,29008,4326,0.5677399338113623,0.41860865968008826,0.14913127413127408
North Carolina,37107,Lenoir County,14590,13605,28409,985,0.5135696434228589,0.4788975324721039,0.03467211095075501
North Carolina,37109,Lincoln County,36341,13274,50217,23067,0.7236792321325447,0.26433279566680606,0.45934643646573864
North Carolina,37111,McDowell County,16883,5832,23003,11051,0.733947745946181,0.2535321479806982,0.4804155979654828
North Carolina,37113,Macon County,14211,6230,20743,7981,0.6850985874752928,0.3003422841440486,0.3847563033312442
North Carolina,37115,Madison County,7979,4901,13076,3078,0.6102018966044662,0.3748088100336494,0.2353930865708168
North Carolina,37117,Martin County,6532,5911,12540,621,0.5208931419457735,0.47137161084529505,0.049521531100478466
North Carolina,37119,Mecklenburg County,179211,378107,567053,-198896,0.3160392414818368,0.6667930510904625,-0.3507538096086257
North Carolina,37121,Mitchell County,7090,1867,9041,5223,0.7842052870257715,0.2065037053423294,0.5777015816834421
North Carolina,37123,Montgomery County,8411,4327,12849,4084,0.6546034710872441,0.33675772433652423,0.3178457467507199
North Carolina,37125,Moore County,36764,20779,58339,15985,0.6301787826325442,0.35617682853665644,0.2740019540958878
North Carolina,37127,Nash County,25827,25947,52271,-120,0.4940980658491324,0.4963937938818848,-0.0022957280327524088
North Carolina,37129,New Hanover County,63331,66138,131830,-2807,0.48039899871046043,0.5016915724797087,-0.021292573769248313
North Carolina,37131,Northampton County,3989,6069,10109,-2080,0.394598872292017,0.6003561183104165,-0.20575724601839945
North Carolina,37133,Onslow County,46078,24266,72235,21812,0.6378902194227175,0.33593133522530627,0.30195888419741124
North Carolina,37135,Orange County,20176,63594,84997,-43418,0.23737308375589727,0.7481911126275045,-0.5108180288716072
North Carolina,37137,Pamlico County,4849,2713,7631,2136,0.6354344122657581,0.3555235224741187,0.2799108897916394
North Carolina,37139,Pasquotank County,9770,9832,19897,-62,0.4910287983113032,0.4941448459566769,-0.0031160476453737096
North Carolina,37141,Pender County,21956,11723,34169,10233,0.6425707512657672,0.3430887646697299,0.29948198659603736
North Carolina,37143,Perquimans County,4903,2492,7484,2411,0.6551309460181721,0.33297701763762694,0.3221539283805452
North Carolina,37145,Person County,13184,8465,21894,4719,0.6021741116287568,0.386635607929113,0.21553850369964378
North Carolina,37147,Pitt County,38982,47252,87573,-8270,0.4451371998218629,0.5395726993479726,-0.09443549952610969
North Carolina,37149,Polk County,7689,4518,12358,3171,0.6221880563197928,0.36559313804822785,0.25659491827156494
North Carolina,37151,Randolph County,56894,15618,73316,41276,0.7760106934366304,0.21302307818211577,0.5629876152545147
North Carolina,37153,Richmond County,11830,8754,20763,3076,0.5697635216490873,0.4216153735009392,0.14814814814814808
North Carolina,37155,Robeson County,27806,19020,47188,8786,0.589259981351191,0.4030685767568026,0.18619140459438838
North Carolina,37157,Rockingham County,31301,15992,47809,15309,0.6547093643456253,0.33449768871969715,0.32021167562592817
North Carolina,37159,Rowan County,49297,23114,73408,26183,0.6715480601569311,0.31487031386224934,0.3566777462946818
North Carolina,37161,Rutherford County,24891,9135,34429,15756,0.7229661041563797,0.2653286473612362,0.45763745679514356
North Carolina,37163,Sampson County,17411,10966,28618,6445,0.608393318890209,0.38318540778530996,0.22520791110489902
North Carolina,37165,Scotland County,7473,7186,14775,287,0.5057868020304569,0.48636209813874787,0.019424703891709028
North Carolina,37167,Stanly County,25458,8129,33939,17329,0.7501104923539291,0.23951795869059195,0.5105925336633372
North Carolina,37169,Stokes County,20142,5286,25701,14856,0.7837049142056729,0.2056729310143574,0.5780319831913154
North Carolina,37171,Surry County,27538,8721,36638,18817,0.7516239969430646,0.2380315519406081,0.5135924450024565
North Carolina,37173,Swain County,4161,2780,7068,1381,0.5887096774193549,0.39332201471420486,0.19538766270515
North Carolina,37175,Transylvania County,11636,8444,20404,3192,0.5702803371887865,0.41384042344638305,0.1564399137424034
North Carolina,37177,Tyrrell County,1044,758,1817,286,0.5745734727572922,0.4171711612548156,0.15740231150247658
North Carolina,37179,Union County,80382,48725,131011,31657,0.6135515338406698,0.37191533535351995,0.2416361984871499
North Carolina,37181,Vance County,8391,12431,20999,-4040,0.39959045668841375,0.5919805705033573,-0.19239011381494353
North Carolina,37183,Wake County,226197,393336,631830,-167139,0.35800294382982767,0.6225345425193486,-0.2645315986895209
North Carolina,37185,Warren County,3752,6400,10293,-2648,0.36451957641115323,0.6217817934518605,-0.25726221704070723
North Carolina,37187,Washington County,2781,3396,6205,-615,0.44818694601128123,0.547300564061241,-0.09911361804995972
North Carolina,37189,Watauga County,14451,17122,32220,-2671,0.4485102420856611,0.5314090626939789,-0.08289882060831782
North Carolina,37191,Wayne County,30709,24215,55537,6494,0.5529466841925204,0.4360156292201595,0.11693105497236084
North Carolina,37193,Wilkes County,27592,7511,35466,20081,0.7779845485817403,0.21178029662211695,0.5662042519596233
North Carolina,37195,Wilson County,19581,20754,40735,-1173,0.48069227936663805,0.5094881551491347,-0.02879587578249665
North Carolina,37197,Yadkin County,15933,3763,19923,12170,0.7997289564824575,0.18887717713195804,0.6108517793504994
North Carolina,37199,Yancey County,7516,3688,11352,3828,0.6620859760394644,0.324876673713883,0.3372093023255814
North Dakota,38001,Adams County,981,258,1269,723,0.7730496453900709,0.2033096926713948,0.5697399527186762
North Dakota,38003,Barnes County,3568,1820,5565,1748,0.6411500449236298,0.3270440251572327,0.3141060197663971
North Dakota,38005,Benson County,1094,822,1961,272,0.5578786333503315,0.4191738908720041,0.13870474247832743
North Dakota,38007,Billings County,541,72,635,469,0.8519685039370078,0.11338582677165354,0.7385826771653543
North Dakota,38009,Bottineau County,2575,821,3471,1754,0.7418611351195621,0.23653125900316913,0.5053298761163929
North Dakota,38011,Bowman County,1395,228,1657,1167,0.8418829209414604,0.1375980687990344,0.7042848521424261
North Dakota,38013,Burke County,994,137,1155,857,0.8606060606060606,0.11861471861471862,0.741991341991342
North Dakota,38015,Burleigh County,34744,14348,50753,20396,0.6845703702244202,0.2827025003448072,0.40186786987961304
North Dakota,38017,Cass County,42619,40311,86053,2308,0.49526454626799765,0.46844386598956456,0.026820680278433096
North Dakota,38019,Cavalier County,1499,474,2020,1025,0.7420792079207921,0.23465346534653464,0.5074257425742574
North Dakota,38021,Dickey County,1742,608,2424,1134,0.7186468646864687,0.2508250825082508,0.46782178217821785
North Dakota,38023,Divide County,904,265,1202,639,0.7520798668885191,0.22046589018302828,0.5316139767054908
North Dakota,38025,Dunn County,1951,342,2338,1609,0.8344739093242087,0.14627887082976904,0.6881950384944397
North Dakota,38027,Eddy County,854,383,1261,471,0.6772402854877082,0.3037272006344171,0.3735130848532911
North Dakota,38029,Emmons County,1738,237,2009,1501,0.8651070184171229,0.11796913887506222,0.7471378795420607
North Dakota,38031,Foster County,1362,373,1778,989,0.766029246344207,0.20978627671541059,0.5562429696287964
North Dakota,38033,Golden Valley County,871,137,1026,734,0.8489278752436648,0.13352826510721247,0.7153996101364523
North Dakota,38035,Grand Forks County,16987,12880,30970,4107,0.5484985469809494,0.41588634162092347,0.13261220536002588
North Dakota,38037,Grant County,1145,207,1381,938,0.8291093410572049,0.1498913830557567,0.6792179580014482
North Dakota,38039,Griggs County,907,308,1250,599,0.7256,0.2464,0.4792
North Dakota,38041,Hettinger County,1091,196,1312,895,0.8315548780487805,0.14939024390243902,0.6821646341463414
North Dakota,38043,Kidder County,1215,221,1460,994,0.8321917808219178,0.15136986301369862,0.6808219178082192
North Dakota,38045,LaMoure County,1645,527,2219,1118,0.7413249211356467,0.23749436683190625,0.5038305543037405
North Dakota,38047,Logan County,930,128,1076,802,0.8643122676579925,0.11895910780669144,0.745353159851301
North Dakota,38049,McHenry County,2364,564,3003,1800,0.7872127872127872,0.1878121878121878,0.5994005994005994
North Dakota,38051,McIntosh County,1153,261,1455,892,0.7924398625429553,0.17938144329896907,0.6130584192439862
North Dakota,38053,McKenzie County,4482,814,5419,3668,0.8270898689795165,0.1502122162760657,0.6768776527034508
North Dakota,38055,McLean County,4198,1230,5536,2968,0.7583092485549133,0.2221820809248555,0.5361271676300579
North Dakota,38057,Mercer County,3856,704,4675,3152,0.824812834224599,0.15058823529411763,0.6742245989304814
North Dakota,38059,Morton County,12243,3872,16619,8371,0.7366869246043685,0.2329863409350743,0.5037005836692942
North Dakota,38061,Mountrail County,2824,1256,4165,1568,0.678031212484994,0.30156062424969987,0.3764705882352941
North Dakota,38063,Nelson County,1141,586,1777,555,0.6420934158694429,0.3297692740574001,0.3123241418120428
North Dakota,38065,Oliver County,918,129,1066,789,0.8611632270168855,0.12101313320825516,0.7401500938086304
North Dakota,38067,Pembina County,2460,786,3331,1674,0.7385169618733113,0.23596517562293606,0.5025517862503752
North Dakota,38069,Pierce County,1585,497,2128,1088,0.7448308270676691,0.23355263157894737,0.5112781954887218
North Dakota,38071,Ramsey County,3577,1639,5372,1938,0.6658600148920327,0.30510052122114667,0.36075949367088606
North Dakota,38073,Ransom County,1418,945,2454,473,0.5778321108394459,0.38508557457212717,0.1927465362673187
North Dakota,38075,Renville County,1065,220,1319,845,0.8074298711144806,0.16679302501895377,0.6406368460955268
North Dakota,38077,Richland County,5072,2510,7812,2562,0.6492575524833589,0.3213005632360471,0.3279569892473118
North Dakota,38079,Rolette County,1257,2482,3804,-1225,0.3304416403785489,0.6524710830704522,-0.3220294426919033
North Dakota,38081,Sargent County,1266,738,2070,528,0.6115942028985507,0.3565217391304348,0.25507246376811593
North Dakota,38083,Sheridan County,688,104,812,584,0.8472906403940886,0.12807881773399016,0.7192118226600985
North Dakota,38085,Sioux County,258,804,1186,-546,0.2175379426644182,0.6779089376053963,-0.4603709949409781
North Dakota,38087,Slope County,380,44,427,336,0.8899297423887588,0.10304449648711944,0.7868852459016393
North Dakota,38089,Stark County,12110,2499,15050,9611,0.8046511627906977,0.16604651162790698,0.6386046511627907
North Dakota,38091,Steele County,652,392,1088,260,0.5992647058823529,0.3602941176470588,0.2389705882352941
North Dakota,38093,Stutsman County,6994,2676,9959,4318,0.7022793453157947,0.26870167687518826,0.43357766844060647
North Dakota,38095,Towner County,830,317,1174,513,0.706984667802385,0.27001703577512776,0.43696763202725725
North Dakota,38097,Traill County,2522,1493,4136,1029,0.6097678916827853,0.3609767891682785,0.2487911025145068
North Dakota,38099,Walsh County,3324,1333,4783,1991,0.6949613213464353,0.27869537946895256,0.4162659418774827
North Dakota,38101,Ward County,19974,7293,28246,12681,0.7071443744246974,0.2581958507399278,0.44894852368476956
North Dakota,38103,Wells County,1893,442,2374,1451,0.7973883740522325,0.18618365627632688,0.6112047177759057
North Dakota,38105,Williams County,11739,2169,14334,9570,0.8189619087484303,0.15131854332356634,0.667643365424864
Ohio,39001,Adams County,9870,2156,12145,7714,0.8126801152737753,0.17752161383285303,0.6351585014409222
Ohio,39003,Allen County,33116,14149,48006,18967,0.6898304378619339,0.2947339915843853,0.3950964462775486
Ohio,39005,Ashland County,19407,6541,26405,12866,0.7349744366597235,0.24771823518273053,0.487256201476993
Ohio,39007,Ashtabula County,26890,16497,44147,10393,0.6091014111944186,0.3736833759938388,0.23541803520057986
Ohio,39009,Athens County,10862,14772,26059,-3910,0.4168233623700065,0.5668674929966614,-0.1500441306266549
Ohio,39011,Auglaize County,20798,4651,25777,16147,0.8068433099274547,0.18043216821197192,0.6264111417154827
Ohio,39013,Belmont County,23560,9138,33088,14422,0.7120406189555126,0.27617263056092844,0.4358679883945842
Ohio,39015,Brown County,16480,4380,21096,12100,0.7811907470610542,0.20762229806598406,0.5735684489950701
Ohio,39017,Butler County,114392,69613,186737,44779,0.612583473012847,0.37278632515248716,0.23979714786035983
Ohio,39019,Carroll County,10745,3251,14212,7494,0.7560512243174782,0.2287503518153673,0.5273008725021109
Ohio,39021,Champaign County,14589,5062,19972,9527,0.730472661726417,0.25345483677148006,0.47701782495493694
Ohio,39023,Clark County,39032,24076,64212,14956,0.6078614589173363,0.3749454930542578,0.23291596586307856
Ohio,39025,Clermont County,74570,34092,110480,40478,0.6749637943519189,0.30858073859522084,0.36638305575669805
Ohio,39027,Clinton County,15488,4697,20527,10791,0.7545184391289521,0.2288205777756126,0.5256978613533395
Ohio,39029,Columbiana County,35726,13359,49860,22367,0.7165262735659848,0.26793020457280387,0.4485960689931809
Ohio,39031,Coshocton County,12325,4125,16739,8200,0.7363044387358862,0.24643049166616882,0.48987394706971743
Ohio,39033,Crawford County,15436,4916,20686,10520,0.7462051629121145,0.2376486512617229,0.5085565116503916
Ohio,39035,Cuyahoga County,202699,416176,625670,-213477,0.323971102977608,0.6651685393258427,-0.34119743634823474
Ohio,39037,Darke County,22004,4731,27134,17273,0.8109383061841232,0.17435689540797522,0.636581410776148
Ohio,39039,Defiance County,13038,5981,19381,7057,0.6727207058459316,0.30860120736804086,0.3641194984778907
Ohio,39041,Delaware County,66356,57735,126070,8621,0.5263425081304037,0.4579598635678591,0.06838264456254461
Ohio,39043,Erie County,22160,17493,40335,4667,0.5493987851741664,0.4336928226106359,0.1157059625635305
Ohio,39045,Fairfield County,50797,31224,83311,19573,0.6097274069450612,0.37478844330280514,0.23493896364225608
Ohio,39047,Fayette County,9473,2975,12612,6498,0.7511100539169046,0.23588645734221375,0.5152235965746907
Ohio,39049,Franklin County,211237,409144,630577,-197907,0.33499001707959536,0.648840664978266,-0.3138506478986706
Ohio,39051,Fulton County,15731,6664,22770,9067,0.6908651734738691,0.29266578831796225,0.39819938515590686
Ohio,39053,Gallia County,10645,2990,13799,7655,0.7714327125153997,0.21668236828755708,0.5547503442278426
Ohio,39055,Geauga County,34143,21201,56021,12942,0.6094678781171347,0.37844736795130396,0.2310205101658307
Ohio,39057,Greene County,52072,34798,88643,17274,0.5874349920467493,0.39256342858432136,0.19487156346242795
Ohio,39059,Guernsey County,13407,4577,18230,8830,0.7354360943499726,0.2510696653867252,0.4843664289632474
Ohio,39061,Hamilton County,177886,246266,430929,-68380,0.41279653956916335,0.5714769718445498,-0.15868043227538647
Ohio,39063,Hancock County,26310,11757,38771,14553,0.6785999845245158,0.30324211395114903,0.3753578705733667
Ohio,39065,Hardin County,9949,3062,13247,6887,0.7510379708613271,0.23114667471880426,0.5198912961425228
Ohio,39067,Harrison County,5792,1768,7655,4024,0.756629653821032,0.2309601567602874,0.5256694970607446
Ohio,39069,Henry County,10479,4062,14764,6417,0.7097670008127879,0.2751286914115416,0.43463830940124626
Ohio,39071,Highland County,15678,3799,19676,11879,0.7968082943687741,0.19307786135393373,0.6037304330148403
Ohio,39073,Hocking County,9737,3880,13824,5857,0.7043547453703703,0.2806712962962963,0.42368344907407407
Ohio,39075,Holmes County,10796,1994,12947,8802,0.8338611261296053,0.15401251255117016,0.6798486135784352
Ohio,39077,Huron County,18956,7759,27190,11197,0.6971680764987127,0.285362265538801,0.4118058109599117
Ohio,39079,Jackson County,11309,3311,14794,7998,0.7644315262944437,0.22380694876301202,0.5406245775314317
Ohio,39081,Jefferson County,22828,10018,33362,12810,0.6842515436724417,0.300281757688388,0.3839697859840537
Ohio,39083,Knox County,22340,8589,31398,13751,0.7115102872794445,0.2735524555704185,0.437957831709026
Ohio,39085,Lake County,73278,55514,130509,17764,0.5614785187228467,0.4253653004773617,0.136113218245485
Ohio,39087,Lawrence County,20306,7489,28127,12817,0.7219397731716856,0.2662566217513421,0.45568315142034344
Ohio,39089,Licking County,59514,33055,94210,26459,0.6317163783037895,0.35086508863178006,0.2808512896720094
Ohio,39091,Logan County,17964,5055,23368,12909,0.7687435809654228,0.21632146525162615,0.5524221157137967
Ohio,39093,Lorain County,79520,75667,157437,3853,0.5050909252589925,0.48061764388295003,0.024473281376042433
Ohio,39095,Lucas County,81763,115411,200623,-33648,0.4075454957806433,0.5752630555818625,-0.16771755980121922
Ohio,39097,Madison County,13835,5698,19855,8137,0.6968018131453034,0.2869806094182826,0.40982120372702086
Ohio,39099,Mahoning County,59903,57641,118966,2262,0.5035304204562648,0.48451658457038144,0.0190138358858834
Ohio,39101,Marion County,19023,8269,27818,10754,0.6838378028614566,0.29725357682076353,0.38658422604069304
Ohio,39103,Medina County,64598,39800,105825,24798,0.6104228679423577,0.3760926057169856,0.23433026222537207
Ohio,39105,Meigs County,8316,2492,10951,5824,0.7593827047758196,0.22755912702036343,0.5318235777554562
Ohio,39107,Mercer County,19452,4030,23761,15422,0.8186524136189555,0.16960565632759564,0.6490467572913599
Ohio,39109,Miami County,41371,15663,57972,25708,0.7136376181604913,0.27018215690333264,0.4434554612571587
Ohio,39111,Monroe County,5463,1605,7148,3858,0.7642697257974258,0.2245383324006715,0.5397313933967542
Ohio,39113,Montgomery County,129034,135064,268505,-6030,0.4805646077354239,0.5030222900877078,-0.022457682352283903
Ohio,39115,Morgan County,5041,1725,6847,3316,0.7362348473784139,0.2519351540820797,0.4842996932963342
Ohio,39117,Morrow County,14077,4048,18457,10029,0.762691661700168,0.21932058297664841,0.5433710787235195
Ohio,39119,Muskingum County,27867,11971,40465,15896,0.6886692203138515,0.29583590757444705,0.3928333127394044
Ohio,39121,Noble County,5135,1170,6343,3965,0.8095538388775028,0.18445530506069682,0.6250985338168059
Ohio,39123,Ottawa County,14628,9008,24007,5620,0.6093222810013746,0.37522389303119924,0.2340983879701754
Ohio,39125,Paulding County,7086,2213,9467,4873,0.7484947713108694,0.23375937466990598,0.5147353966409633
Ohio,39127,Perry County,12357,4098,16675,8259,0.7410494752623689,0.24575712143928036,0.4952923538230885
Ohio,39129,Pickaway County,20593,7304,28271,13289,0.7284142761133316,0.25835661985780484,0.4700576562555268
Ohio,39131,Pike County,9157,3110,12412,6047,0.7377537866580728,0.250563970351273,0.4871898163067998
Ohio,39133,Portage County,45990,35661,82872,10329,0.5549522154648132,0.43031421951925863,0.12463799594555458
Ohio,39135,Preble County,17022,4493,21809,12529,0.7805034618735385,0.20601586500985833,0.5744875968636801
Ohio,39137,Putnam County,16412,3195,19921,13217,0.8238542241855329,0.16038351488379096,0.6634707093017419
Ohio,39139,Richland County,41472,17640,59975,23832,0.6914881200500208,0.2941225510629429,0.3973655689870779
Ohio,39141,Ross County,22278,10557,33299,11721,0.6690290999729721,0.3170365476440734,0.3519925523288987
Ohio,39143,Sandusky County,18896,10596,30074,8300,0.6283168185143313,0.3523309170712243,0.275985901443107
Ohio,39145,Scioto County,22609,9080,32047,13529,0.705495054139233,0.28333385340281464,0.42216120073641833
Ohio,39147,Seneca County,17086,8266,25810,8820,0.6619914761720264,0.3202634637737311,0.34172801239829526
Ohio,39149,Shelby County,20422,4465,25258,15957,0.8085359094148389,0.1767756750336527,0.6317602343811861
Ohio,39151,Stark County,111097,75904,189879,35193,0.5850936649129183,0.399749314036834,0.18534435087608425
Ohio,39153,Summit County,124833,151668,280473,-26835,0.4450802751066948,0.5407579339187729,-0.09567765881207813
Ohio,39155,Trumbull County,55194,44519,101001,10675,0.5464698369323076,0.4407778140810487,0.10569202285125884
Ohio,39157,Tuscarawas County,30458,12889,44015,17569,0.6919913665795752,0.2928319890946268,0.39915937748494834
Ohio,39159,Union County,21669,11141,33445,10528,0.647899536552549,0.3331140678726267,0.31478546867992224
Ohio,39161,Van Wert County,11650,3067,14965,8583,0.7784831272970264,0.2049448713665219,0.5735382559305044
Ohio,39163,Vinton County,4632,1331,6030,3301,0.7681592039800995,0.2207296849087894,0.5474295190713101
Ohio,39165,Warren County,87988,46069,136100,41919,0.6464952240999265,0.3384937545922116,0.30800146950771495
Ohio,39167,Washington County,22307,9243,32031,13064,0.6964190940026849,0.2885642034279292,0.40785489057475566
Ohio,39169,Wayne County,36759,16660,54283,20099,0.6771733323508281,0.3069100823462226,0.3702632500046055
Ohio,39171,Williams County,13452,4842,18651,8610,0.7212481904455526,0.2596107447321859,0.4616374457133666
Ohio,39173,Wood County,35757,30617,67597,5140,0.5289731792831043,0.45293430181812805,0.07603887746497623
Ohio,39175,Wyandot County,8462,2733,11390,5729,0.7429323968393328,0.2399473222124671,0.5029850746268657
Oklahoma,40001,Adair County,5585,1387,7108,4198,0.7857343837929094,0.19513224535734383,0.5906021384355655
Oklahoma,40003,Alfalfa County,1978,232,2262,1746,0.874447391688771,0.10256410256410256,0.7718832891246684
Oklahoma,40005,Atoka County,4557,765,5389,3792,0.8456114306921507,0.14195583596214512,0.7036555947300056
Oklahoma,40007,Beaver County,1968,190,2178,1778,0.9035812672176309,0.08723599632690542,0.8163452708907255
Oklahoma,40009,Beckham County,6767,1048,7948,5719,0.8514091595369905,0.1318570709612481,0.7195520885757424
Oklahoma,40011,Blaine County,3136,688,3901,2448,0.803896436811074,0.17636503460651115,0.6275314022045628
Oklahoma,40013,Bryan County,12344,3323,15976,9021,0.7726589884827241,0.20799949924887332,0.5646594892338508
Oklahoma,40015,Caddo County,7013,2670,9859,4343,0.7113297494674916,0.2708185414342225,0.4405112080332691
Oklahoma,40017,Canadian County,43550,16742,61940,26808,0.7030997739748144,0.2702938327413626,0.4328059412334518
Oklahoma,40019,Carter County,14699,4470,19479,10229,0.7546075260536989,0.22947789927614354,0.5251296267775554
Oklahoma,40021,Cherokee County,11223,6027,17714,5196,0.6335666704301682,0.34023935869933386,0.2933273117308344
Oklahoma,40023,Choctaw County,4698,1082,5832,3616,0.8055555555555556,0.1855281207133059,0.6200274348422496
Oklahoma,40025,Cimarron County,970,70,1054,900,0.920303605313093,0.06641366223908918,0.8538899430740038
Oklahoma,40027,Cleveland County,66677,49827,119778,16850,0.5566715089582394,0.41599458999148425,0.1406769189667551
Oklahoma,40029,Coal County,2091,374,2524,1717,0.8284469096671949,0.14817749603803487,0.68026941362916
Oklahoma,40031,Comanche County,20905,13747,35631,7158,0.5867082035306335,0.38581572226432037,0.2008924812663131
Oklahoma,40033,Cotton County,2117,393,2572,1724,0.823094867807154,0.15279937791601866,0.6702954898911353
Oklahoma,40035,Craig County,4686,1217,6032,3469,0.7768567639257294,0.20175729442970822,0.5750994694960212
Oklahoma,40037,Creek County,23294,6577,30505,16717,0.763612522537289,0.21560399934436977,0.5480085231929192
Oklahoma,40039,Custer County,8060,2369,10691,5691,0.7539051538677393,0.22158825180057992,0.5323169020671593
Oklahoma,40041,Delaware County,13557,3472,17245,10085,0.7861409104088142,0.20133371991881704,0.5848071904899972
Oklahoma,40043,Dewey County,2124,214,2359,1910,0.9003815175922001,0.0907164052564646,0.8096651123357355
Oklahoma,40045,Ellis County,1688,162,1873,1526,0.9012279765082755,0.08649225840896957,0.8147357180993059
Oklahoma,40047,Garfield County,16970,4919,22430,12051,0.7565760142666073,0.2193045028979046,0.5372715113687027
Oklahoma,40049,Garvin County,8878,1865,10922,7013,0.8128547885002747,0.17075627174510163,0.642098516755173
Oklahoma,40051,Grady County,18538,4144,23101,14394,0.8024760832864378,0.17938617375871174,0.623089909527726
Oklahoma,40053,Grant County,1916,280,2226,1636,0.8607367475292004,0.12578616352201258,0.7349505840071878
Oklahoma,40055,Greer County,1605,328,1973,1277,0.8134820070957932,0.16624429802331475,0.6472377090724785
Oklahoma,40057,Harmon County,747,177,933,570,0.8006430868167203,0.18971061093247588,0.6109324758842444
Oklahoma,40059,Harper County,1327,136,1487,1191,0.8924008069939475,0.09145931405514458,0.8009414929388029
Oklahoma,40061,Haskell County,4165,783,5014,3382,0.8306741124850419,0.15616274431591542,0.6745113681691264
Oklahoma,40063,Hughes County,3875,919,4857,2956,0.7978175828700844,0.18921144739551163,0.6086061354745728
Oklahoma,40065,Jackson County,6392,1646,8221,4746,0.7775209828488019,0.2002189514657584,0.5773020313830435
Oklahoma,40067,Jefferson County,2026,319,2385,1707,0.8494758909853249,0.13375262054507336,0.7157232704402516
Oklahoma,40069,Johnston County,3441,738,4251,2703,0.8094565984474241,0.17360621030345802,0.6358503881439661
Oklahoma,40071,Kay County,12834,4040,17249,8794,0.7440431329352426,0.23421647631746767,0.5098266566177749
Oklahoma,40073,Kingfisher County,5521,854,6465,4667,0.8539829853054911,0.13209590100541377,0.7218870843000773
Oklahoma,40075,Kiowa County,2673,699,3427,1974,0.7799824919754887,0.2039684855558798,0.576014006419609
Oklahoma,40077,Latimer County,3437,762,4249,2675,0.8088962108731467,0.179336314426924,0.6295598964462227
Oklahoma,40079,Le Flore County,15213,3299,18805,11914,0.8089869715501197,0.1754320659399096,0.6335549056102101
Oklahoma,40081,Lincoln County,12013,2609,14888,9404,0.8068914562063407,0.17524180548092425,0.6316496507254165
Oklahoma,40083,Logan County,15608,5455,21574,10153,0.7234634282006118,0.2528506535644758,0.47061277463613604
Oklahoma,40085,Love County,3305,711,4076,2594,0.8108439646712463,0.17443572129538765,0.6364082433758587
Oklahoma,40087,McClain County,15295,3582,19236,11713,0.7951237263464338,0.18621334996880848,0.6089103763776254
Oklahoma,40089,McCurtain County,9485,1858,11467,7627,0.8271561873201361,0.16203017354146682,0.6651260137786692
Oklahoma,40091,McIntosh County,6172,2031,8335,4141,0.740491901619676,0.24367126574685063,0.49682063587282543
Oklahoma,40093,Major County,3084,320,3467,2764,0.8895298528987597,0.0922988174214018,0.797231035477358
Oklahoma,40095,Marshall County,4891,1100,6064,3791,0.8065633245382586,0.18139841688654354,0.6251649076517151
Oklahoma,40097,Mayes County,12749,3581,16626,9168,0.766811018886082,0.21538554071935523,0.5514254781667268
Oklahoma,40099,Murray County,4612,1156,5894,3456,0.7824906684764167,0.19613165931455717,0.5863590091618596
Oklahoma,40101,Muskogee County,16526,8027,25081,8499,0.6589051473226746,0.32004306048403175,0.33886208683864283
Oklahoma,40103,Noble County,3821,1003,4938,2818,0.7737950587282301,0.20311867152693397,0.5706763872012961
Oklahoma,40105,Nowata County,3610,712,4391,2898,0.8221361876565703,0.1621498519699385,0.6599863356866318
Oklahoma,40107,Okfuskee County,3058,896,4038,2162,0.7573055968301139,0.2218920257553244,0.5354135710747895
Oklahoma,40109,Oklahoma County,145050,141724,294740,3326,0.4921286557644025,0.480844133812852,0.011284521951550497
Oklahoma,40111,Okmulgee County,9668,4357,14313,5311,0.6754698525815692,0.30440857961293927,0.37106127296862995
Oklahoma,40113,Osage County,14121,6002,20538,8119,0.6875547765118317,0.2922387769013536,0.39531599961047814
Oklahoma,40115,Ottawa County,8545,2686,11438,5859,0.7470711662878126,0.2348312642070292,0.5122399020807833
Oklahoma,40117,Pawnee County,5267,1363,6786,3904,0.7761567933981727,0.20085470085470086,0.5753020925434718
Oklahoma,40119,Payne County,17813,10904,29643,6909,0.6009175859393449,0.3678440103903114,0.23307357554903346
Oklahoma,40121,Pittsburg County,13851,3768,17924,10083,0.7727627761660344,0.21022093282749385,0.5625418433385405
Oklahoma,40123,Pontotoc County,10805,4117,15320,6688,0.7052872062663186,0.268733681462141,0.4365535248041776
Oklahoma,40125,Pottawatomie County,20240,7275,28185,12965,0.7181124711726096,0.2581160191591272,0.4599964520134824
Oklahoma,40127,Pushmataha County,4016,668,4739,3348,0.8474361679679258,0.1409580080185693,0.7064781599493565
Oklahoma,40129,Roger Mills County,1629,168,1834,1461,0.8882224645583424,0.0916030534351145,0.7966194111232279
Oklahoma,40131,Rogers County,34031,9589,44553,24442,0.7638318407290193,0.21522680852018944,0.5486050322088298
Oklahoma,40133,Seminole County,6011,2150,8337,3861,0.7210027587861341,0.2578865299268322,0.46311622885930187
Oklahoma,40135,Sequoyah County,12113,3035,15386,9078,0.7872741453269205,0.1972572468477837,0.5900168984791369
Oklahoma,40137,Stephens County,15560,3154,19057,12406,0.8164978747966627,0.16550348953140578,0.6509943852652569
Oklahoma,40139,Texas County,4505,894,5521,3611,0.8159753667813802,0.16192718710378554,0.6540481796775947
Oklahoma,40141,Tillman County,2076,597,2708,1479,0.7666174298375185,0.22045790251107827,0.5461595273264401
Oklahoma,40143,Tulsa County,150574,108996,266678,41578,0.5646285032886103,0.4087176295007462,0.15591087378786406
Oklahoma,40145,Wagoner County,26165,8464,35338,17701,0.7404210764615994,0.23951553568396627,0.500905540777633
Oklahoma,40147,Washington County,17076,5790,23501,11286,0.7266073784094293,0.24637249478745585,0.48023488362197353
Oklahoma,40149,Washita County,4086,598,4777,3488,0.855348545111995,0.12518316935315052,0.7301653757588444
Oklahoma,40151,Woods County,2993,591,3678,2402,0.813757476889614,0.16068515497553018,0.6530723219140838
Oklahoma,40153,Woodward County,6611,1005,7785,5606,0.8491971740526654,0.12909441233140656,0.7201027617212588
Oregon,41001,Baker County,7352,2346,9932,5006,0.7402335884011276,0.23620620217478855,0.5040273862263391
Oregon,41003,Benton County,14878,35827,52799,-20949,0.2817856398795432,0.6785545180779939,-0.39676887819845075
Oregon,41005,Clackamas County,110509,139043,257679,-28534,0.42886304277803006,0.5395977165387944,-0.11073467376076435
Oregon,41007,Clatsop County,10218,12916,23910,-2698,0.4273525721455458,0.5401923881221247,-0.11283981597657888
Oregon,41009,Columbia County,17150,13835,32221,3315,0.532261568542255,0.42937835573073463,0.10288321281152041
Oregon,41011,Coos County,21829,14243,37075,7586,0.5887795010114633,0.3841672285906945,0.20461227242076874
Oregon,41013,Crook County,11287,3801,15448,7486,0.7306447436561367,0.24605126877265665,0.4845934748834801
Oregon,41015,Curry County,8484,6058,14925,2426,0.5684422110552764,0.40589614740368507,0.1625460636515913
Oregon,41017,Deschutes County,55646,65962,125234,-10316,0.4443362026286791,0.5267099988820927,-0.08237379625341357
Oregon,41019,Douglas County,43298,19160,64349,24138,0.6728620491382927,0.2977513248069123,0.37511072433138043
Oregon,41021,Gilliam County,834,324,1178,510,0.7079796264855688,0.27504244482173174,0.43293718166383705
Oregon,41023,Grant County,3545,929,4596,2616,0.7713228894691035,0.20213228894691035,0.5691906005221932
Oregon,41025,Harney County,3475,894,4481,2581,0.7754965409506807,0.19950903816112475,0.5759875027895559
Oregon,41027,Hood River County,3955,8764,13090,-4809,0.30213903743315507,0.6695187165775401,-0.3673796791443851
Oregon,41029,Jackson County,63869,59478,127165,4391,0.5022529784138717,0.4677230369991743,0.03452994141469745
Oregon,41031,Jefferson County,7189,4393,11913,2796,0.6034584067825065,0.368756820280366,0.2347015865021405
Oregon,41033,Josephine County,31751,18451,51641,13300,0.614840920973645,0.35729362328382486,0.2575472976898201
Oregon,41035,Klamath County,25308,10388,36726,14920,0.6891030877307629,0.2828513859391167,0.4062517017916462
Oregon,41037,Lake County,3470,792,4363,2678,0.7953243181297273,0.18152647261058905,0.6137978455191382
Oregon,41039,Lane County,80336,134366,222253,-54030,0.36146193752165323,0.6045632679873838,-0.24310133046573057
Oregon,41041,Lincoln County,12460,17385,30726,-4925,0.4055197552561349,0.5658074594805702,-0.16028770422443533
Oregon,41043,Linn County,43486,26512,72640,16974,0.5986508810572687,0.36497797356828193,0.23367290748898678
Oregon,41045,Malheur County,8187,3260,11804,4927,0.6935784479837344,0.2761775669264656,0.41740088105726875
Oregon,41047,Marion County,79002,80872,165534,-1870,0.47725542788792635,0.4885522007563401,-0.01129677286841374
Oregon,41049,Morrow County,3586,1371,5118,2215,0.7006643220007815,0.26787807737397423,0.4327862446268073
Oregon,41051,Multnomah County,82995,367249,463659,-284254,0.17900008411354035,0.7920670147673182,-0.6130669306537779
Oregon,41053,Polk County,23732,22917,48291,815,0.49143732786647615,0.47456047710753557,0.016876850758940576
Oregon,41055,Sherman County,921,260,1208,661,0.7624172185430463,0.2152317880794702,0.5471854304635762
Oregon,41057,Tillamook County,8354,8066,16888,288,0.49467077214590244,0.4776172430127901,0.01705352913311231
Oregon,41059,Umatilla County,21270,10707,33038,10563,0.643804104364671,0.32408136085719474,0.3197227435074762
Oregon,41061,Union County,10298,4254,14944,6044,0.6891059957173448,0.2846627408993576,0.40444325481798715
Oregon,41063,Wallowa County,3404,1625,5149,1779,0.6610992425713731,0.31559526121577003,0.34550398135560306
Oregon,41065,Wasco County,7035,6604,14130,431,0.4978768577494692,0.46737438075017695,0.03050247699929226
Oregon,41067,Washington County,99073,209940,320326,-110867,0.30928803781147957,0.6553948165306593,-0.3461067787191798
Oregon,41069,Wheeler County,711,217,965,494,0.7367875647668394,0.22487046632124352,0.5119170984455959
Oregon,41071,Yamhill County,29551,27174,58923,2377,0.5015189314868558,0.4611781477521511,0.04034078373470468
Pennsylvania,42001,Adams County,37523,18207,56714,19316,0.6616179426596608,0.3210318439891385,0.3405860986705223
Pennsylvania,42003,Allegheny County,282913,430759,724800,-147846,0.3903325055187638,0.594314293598234,-0.20398178807947015
Pennsylvania,42005,Armstrong County,27489,8457,36370,19032,0.7558152323343414,0.2325268078086335,0.5232884245257079
Pennsylvania,42007,Beaver County,54759,38122,94122,16637,0.581787467329636,0.4050275174773167,0.17675994985231935
Pennsylvania,42009,Bedford County,23025,4367,27574,18658,0.8350257488938856,0.15837383041996084,0.6766519184739248
Pennsylvania,42011,Berks County,109736,92895,205540,16841,0.5338912133891214,0.4519558236839545,0.0819353897051669
Pennsylvania,42013,Blair County,45306,17636,63595,27670,0.7124144979951254,0.27731739916660114,0.4350970988285242
Pennsylvania,42015,Bradford County,21600,8046,30159,13554,0.7162041181736795,0.26678603401969564,0.4494180841539838
Pennsylvania,42017,Bucks County,187367,204712,396234,-17345,0.47286956697305127,0.5166442051918816,-0.04377463821883032
Pennsylvania,42019,Butler County,74359,37508,113305,36851,0.6562728917523498,0.33103570010149597,0.32523719165085385
Pennsylvania,42021,Cambria County,48085,21730,70574,26355,0.681341570550061,0.3079037605917193,0.37343780995834164
Pennsylvania,42023,Cameron County,1771,634,2434,1137,0.727608874281019,0.26047658175842237,0.4671322925225966
Pennsylvania,42025,Carbon County,21984,11212,33629,10772,0.6537214903803265,0.33340271789229536,0.3203187724880311
Pennsylvania,42027,Centre County,36372,40055,77493,-3683,0.4693585227052766,0.5168853961002929,-0.04752687339501632
Pennsylvania,42029,Chester County,128565,182372,315753,-53807,0.4071695280804933,0.5775780435973689,-0.17040851551687558
Pennsylvania,42031,Clarion County,14578,4678,19493,9900,0.7478582055096702,0.23998358385061305,0.5078746216590572
Pennsylvania,42033,Clearfield County,29203,9673,39496,19530,0.7393913307676727,0.24491087705084058,0.49448045371683214
Pennsylvania,42035,Clinton County,11902,5502,17625,6400,0.675290780141844,0.31217021276595747,0.3631205673758865
Pennsylvania,42037,Columbia County,20098,10532,31171,9566,0.6447659683680343,0.33787815597831317,0.3068878123897212
Pennsylvania,42039,Crawford County,28559,12924,42004,15635,0.6799114370059994,0.3076849823826302,0.37222645462336923
Pennsylvania,42041,Cumberland County,77212,62245,141595,14967,0.5453017408806808,0.4395988558918041,0.10570288498887676
Pennsylvania,42043,Dauphin County,66408,78983,147368,-12575,0.45062700179143367,0.5359576027360078,-0.08533060094457412
Pennsylvania,42045,Delaware County,118532,206423,329006,-87891,0.3602730649289071,0.6274140897126497,-0.2671410247837426
Pennsylvania,42047,Elk County,12140,4522,16906,7618,0.7180882526913522,0.26747900153791554,0.4506092511534367
Pennsylvania,42049,Erie County,66869,68286,137083,-1417,0.4877993624300606,0.49813616568064606,-0.010336803250585447
Pennsylvania,42051,Fayette County,41227,20444,62139,20783,0.6634641690403772,0.329004329004329,0.3344598400360482
Pennsylvania,42053,Forest County,1882,728,2646,1154,0.7112622826908541,0.2751322751322751,0.436130007558579
Pennsylvania,42055,Franklin County,57245,22422,80783,34823,0.7086268150477204,0.27755839718752706,0.43106841786019334
Pennsylvania,42057,Fulton County,6824,1085,7977,5739,0.8554594459069825,0.13601604613263132,0.7194433997743512
Pennsylvania,42059,Greene County,12579,4911,17669,7668,0.7119248401154564,0.27794442243477274,0.4339804176806837
Pennsylvania,42061,Huntingdon County,17061,5445,22792,11616,0.7485521235521235,0.2388996138996139,0.5096525096525096
Pennsylvania,42063,Indiana County,28089,12634,41198,15455,0.6818049419874751,0.30666537210544204,0.37513956988203306
Pennsylvania,42065,Jefferson County,17960,4527,22824,13433,0.7868909919383106,0.19834384858044163,0.588547143357869
Pennsylvania,42067,Juniata County,9649,2253,12043,7396,0.8012123225110023,0.1870796313210994,0.6141326911899029
Pennsylvania,42069,Lackawanna County,52334,61991,115410,-9657,0.4534615717875401,0.5371371631574386,-0.08367559136989855
Pennsylvania,42071,Lancaster County,160209,115847,281375,44362,0.5693789426921368,0.4117174589071524,0.15766148378498446
Pennsylvania,42073,Lawrence County,29597,15978,46076,13619,0.6423517666464102,0.346774893653963,0.2955768729924472
Pennsylvania,42075,Lebanon County,46731,23932,71858,22799,0.6503242506053606,0.3330457290767903,0.3172785215285703
Pennsylvania,42077,Lehigh County,84259,98288,184713,-14029,0.45616172115660514,0.5321119791243714,-0.07595025796776622
Pennsylvania,42079,Luzerne County,86929,64873,153321,22056,0.5669738652891646,0.42311881607868457,0.14385504921048003
Pennsylvania,42081,Lycoming County,41462,16971,59254,24491,0.699733351334931,0.2864110439801532,0.41332230735477776
Pennsylvania,42083,McKean County,14083,5098,19466,8985,0.7234665570738724,0.2618925305661153,0.46157402650775714
Pennsylvania,42085,Mercer County,36143,21067,57954,15076,0.6236497912137212,0.36351244090140455,0.26013735031231666
Pennsylvania,42087,Mifflin County,16670,4603,21502,12067,0.7752767184447958,0.21407310947818808,0.5612036089666077
Pennsylvania,42089,Monroe County,38726,44060,83829,-5334,0.4619642367199895,0.5255937682663517,-0.06362953154636225
Pennsylvania,42091,Montgomery County,185460,319511,510157,-134051,0.3635351470233673,0.6262993549044706,-0.26276420788110333
Pennsylvania,42093,Montour County,5844,3771,9817,2073,0.5952938779667923,0.3841295711520831,0.2111643068147092
Pennsylvania,42095,Northampton County,83854,85087,171399,-1233,0.48923272597856465,0.4964264668988734,-0.007193740920308722
Pennsylvania,42097,Northumberland County,28952,12677,42283,16275,0.6847196272733723,0.299813163682804,0.38490646359056835
Pennsylvania,42099,Perry County,18293,5950,24652,12343,0.7420493266266429,0.24135972740548434,0.5006895992211586
Pennsylvania,42101,Philadelphia County,132740,603790,741377,-471050,0.17904520911762842,0.814416956555167,-0.6353717474375385
Pennsylvania,42103,Pike County,19213,13019,32554,6194,0.5901886096946611,0.3999201327025865,0.19026847699207466
Pennsylvania,42105,Potter County,7239,1726,9064,5513,0.7986540158870256,0.19042365401588704,0.6082303618711385
Pennsylvania,42107,Schuylkill County,48871,20727,70603,28144,0.6921943826749571,0.2935710947126893,0.39862328796226787
Pennsylvania,42109,Snyder County,13983,4910,19140,9073,0.730564263322884,0.25653082549634276,0.4740334378265413
Pennsylvania,42111,Somerset County,31466,8654,40543,22812,0.7761142490688898,0.21345238388871074,0.5626618651801791
Pennsylvania,42113,Sullivan County,2619,921,3595,1698,0.7285118219749652,0.25618915159944367,0.47232267037552156
Pennsylvania,42115,Susquehanna County,15207,6236,21752,8971,0.699108127988231,0.286686281721221,0.41242184626700995
Pennsylvania,42117,Tioga County,15742,4955,21075,10787,0.7469513641755635,0.2351126927639383,0.5118386714116252
Pennsylvania,42119,Union County,12356,7475,20115,4881,0.6142679592344021,0.37161322396221724,0.2426547352721849
Pennsylvania,42121,Venango County,18569,7585,26528,10984,0.6999773823884198,0.2859243063932449,0.4140530759951749
Pennsylvania,42123,Warren County,14237,6066,20650,8171,0.6894430992736077,0.2937530266343826,0.3956900726392251
Pennsylvania,42125,Washington County,72080,45088,118478,26992,0.6083829909350259,0.38056010398555007,0.22782288694947583
Pennsylvania,42127,Wayne County,18637,9191,28089,9446,0.6634981665420627,0.32720993983409874,0.336288226707964
Pennsylvania,42129,Westmoreland County,130218,72129,205183,58089,0.6346432209296092,0.3515349712208126,0.2831082497087966
Pennsylvania,42131,Wyoming County,9936,4704,14858,5232,0.6687306501547987,0.3165971193969579,0.3521335307578408
Pennsylvania,42133,York County,146733,88114,238471,58619,0.6153075216693015,0.36949566194631633,0.24581185972298514
Rhode Island,44001,Bristol County,9745,18050,28415,-8305,0.34295266584550416,0.6352278726024987,-0.29227520675699453
Rhode Island,44003,Kent County,42001,49113,93093,-7112,0.45117248343054794,0.5275692049885599,-0.07639672155801192
Rhode Island,44005,Newport County,15722,29486,46148,-13764,0.3406864869550143,0.638944266273728,-0.2982577793187137
Rhode Island,44007,Providence County,102551,165012,272667,-62461,0.37610345219626873,0.6051777442814862,-0.22907429208521746
Rhode Island,44009,Washington County,29818,44549,76060,-14731,0.3920326058374967,0.5857086510649487,-0.19367604522745202
South Carolina,45001,Abbeville County,8215,4101,12433,4114,0.6607415748411486,0.3298479852006756,0.330893589640473
South Carolina,45003,Aiken County,51589,32275,85185,19314,0.6056113165463404,0.37888125843751835,0.22673005810882202
South Carolina,45005,Allendale County,835,2718,3593,-1883,0.23239632618981354,0.7564709156693571,-0.5240745894795436
South Carolina,45007,Anderson County,67565,27169,96093,40396,0.7031209349276222,0.28273651566711416,0.420384419260508
South Carolina,45009,Bamberg County,2417,4010,6482,-1593,0.3728787411292811,0.6186362233878433,-0.2457574822585622
South Carolina,45011,Barnwell County,5492,4720,10321,772,0.5321189807189226,0.45732002712915415,0.07479895358976846
South Carolina,45013,Beaufort County,53194,43419,97835,9775,0.5437113507435989,0.4437982317166658,0.09991311902693306
South Carolina,45015,Berkeley County,57397,45223,104458,12174,0.5494744299144153,0.4329299814279423,0.116544448486473
South Carolina,45017,Calhoun County,4305,3905,8291,400,0.519237727656495,0.4709926426245326,0.0482450850319624
South Carolina,45019,Charleston County,93297,121485,218857,-28188,0.42629205371543977,0.5550884824337353,-0.12879642871829555
South Carolina,45021,Cherokee County,18043,6983,25270,11060,0.714008705975465,0.27633557578155915,0.4376731301939058
South Carolina,45023,Chester County,8660,6941,15757,1719,0.5495970045059339,0.4405026337500793,0.10909437075585454
South Carolina,45025,Chesterfield County,11297,7431,18876,3866,0.5984848484848485,0.39367450731087095,0.20481034117397756
South Carolina,45027,Clarendon County,8361,8250,16733,111,0.4996713081933903,0.49303770991454016,0.006633598278850128
South Carolina,45029,Colleton County,10440,8602,19283,1838,0.5414095317118706,0.44609241300627495,0.09531711870559562
South Carolina,45031,Darlington County,16832,15220,32417,1612,0.5192337353857543,0.46950674029058825,0.04972699509516609
South Carolina,45033,Dillon County,6582,6436,13101,146,0.5024043966109457,0.49126020914434015,0.01114418746660556
South Carolina,45035,Dorchester County,41913,33824,77278,8089,0.5423665208726934,0.43769248686560214,0.1046740340070913
South Carolina,45037,Edgefield County,8184,4953,13304,3231,0.6151533373421527,0.372294046903187,0.2428592904389657
South Carolina,45039,Fairfield County,4625,7382,12136,-2757,0.38109756097560976,0.6082729070533949,-0.2271753460777851
South Carolina,45041,Florence County,32615,31153,64510,1462,0.5055805301503643,0.48291737715082933,0.022663152999534975
South Carolina,45043,Georgetown County,20487,15822,36668,4665,0.5587160466892113,0.4314934002399913,0.12722264644922
South Carolina,45045,Greenville County,150021,103030,258155,46991,0.5811276171292441,0.3991013151013926,0.18202630202785153
South Carolina,45047,Greenwood County,19431,12145,32006,7286,0.6071049178279073,0.3794601012310192,0.22764481659688812
South Carolina,45049,Hampton County,3906,5323,9305,-1417,0.4197743148844707,0.5720580333154218,-0.15228371843095112
South Carolina,45051,Horry County,118821,59180,179744,59641,0.6610568363895318,0.3292460388107531,0.33181079757877874
South Carolina,45053,Jasper County,7078,7185,14394,-107,0.4917326663887731,0.4991663192997082,-0.007433652910935118
South Carolina,45055,Kershaw County,20471,12699,33629,7772,0.6087305599333909,0.3776205061107972,0.23111005382259364
South Carolina,45057,Lancaster County,30312,18937,49868,11375,0.607844710034491,0.37974252025346916,0.22810218978102187
South Carolina,45059,Laurens County,20004,10159,30488,9845,0.656127000787195,0.3332130674363684,0.3229139333508266
South Carolina,45061,Lee County,3008,5329,8431,-2321,0.35677855533151465,0.6320721148143755,-0.2752935594828609
South Carolina,45063,Lexington County,92817,49301,144568,43516,0.6420300481434342,0.34102290963422055,0.3010071385092137
South Carolina,45065,McCormick County,2958,2687,5697,271,0.5192206424433913,0.47165174653326314,0.04756889591012814
South Carolina,45067,Marion County,5711,8872,14704,-3161,0.3883977149075082,0.6033732317736671,-0.2149755168661589
South Carolina,45069,Marlboro County,5044,6290,11446,-1246,0.4406779661016949,0.5495369561418836,-0.10885899004018867
South Carolina,45071,Newberry County,11443,6958,18631,4485,0.614191401427728,0.37346358220170683,0.24072781922602116
South Carolina,45073,Oconee County,29698,10414,40668,19284,0.7302547457460411,0.2560735713583161,0.474181174387725
South Carolina,45075,Orangeburg County,13603,27295,41205,-13692,0.33012983861181894,0.6624196092707195,-0.3322897706589006
South Carolina,45077,Pickens County,42907,13645,57546,29262,0.7456122058874639,0.237114656101206,0.5084975497862579
South Carolina,45079,Richland County,58313,132570,193822,-74257,0.3008585196726894,0.6839780829833558,-0.38311956331066643
South Carolina,45081,Saluda County,6210,2963,9274,3247,0.6696139745525124,0.31949536338149664,0.3501186111710157
South Carolina,45083,Spartanburg County,93560,52926,148655,40634,0.6293767448118126,0.3560324240691534,0.2733443207426592
South Carolina,45085,Sumter County,21000,27379,48920,-6379,0.42927228127555195,0.5596688470973017,-0.13039656582174974
South Carolina,45087,Union County,8183,4935,13257,3248,0.6172588066681753,0.3722561665535189,0.24500264011465644
South Carolina,45089,Williamsburg County,5532,10289,15985,-4757,0.3460744447919925,0.6436659368157648,-0.2975914920237723
South Carolina,45091,York County,82727,59008,144050,23719,0.5742936480388754,0.40963554321416173,0.16465810482471366
South Dakota,46003,Aurora County,1052,317,1405,735,0.7487544483985765,0.22562277580071174,0.5231316725978647
South Dakota,46005,Beadle County,4808,2107,7081,2701,0.6790001412229911,0.29755684225391893,0.3814432989690722
South Dakota,46007,Bennett County,694,466,1183,228,0.5866441251056635,0.39391377852916315,0.1927303465765004
South Dakota,46009,Bon Homme County,2235,721,3001,1514,0.7447517494168611,0.24025324891702765,0.5044985004998335
South Dakota,46011,Brookings County,8000,6110,14567,1890,0.5491865174709961,0.41944120271847324,0.12974531475252288
South Dakota,46013,Brown County,10580,6538,17547,4042,0.6029520715791873,0.37259930472445435,0.23035276685473294
South Dakota,46015,Brule County,1750,673,2490,1077,0.7028112449799196,0.27028112449799196,0.4325301204819277
South Dakota,46017,Buffalo County,183,352,549,-169,0.3333333333333333,0.6411657559198543,-0.30783242258652094
South Dakota,46019,Butte County,3731,939,4802,2792,0.7769679300291545,0.19554352353186172,0.5814244064972929
South Dakota,46021,Campbell County,747,117,873,630,0.8556701030927835,0.13402061855670103,0.7216494845360825
South Dakota,46023,Charles Mix County,2552,1177,3783,1375,0.6745968807824478,0.3111287338091462,0.36346814697330165
South Dakota,46025,Clark County,1373,437,1850,936,0.7421621621621621,0.23621621621621622,0.5059459459459459
South Dakota,46027,Clay County,2456,3083,5698,-627,0.431028431028431,0.5410670410670411,-0.11003861003861004
South Dakota,46029,Codington County,8958,3837,13161,5121,0.6806473672213358,0.29154319580578986,0.38910417141554593
South Dakota,46031,Corson County,647,622,1283,25,0.5042868277474669,0.4848012470771629,0.019485580670304037
South Dakota,46033,Custer County,3852,1522,5494,2330,0.7011285038223517,0.27702948671277755,0.42409901710957415
South Dakota,46035,Davison County,5613,2648,8454,2965,0.6639460610361959,0.3132245091081145,0.3507215519280814
South Dakota,46037,Day County,1869,1052,2964,817,0.6305668016194332,0.3549257759784076,0.27564102564102566
South Dakota,46039,Deuel County,1699,609,2350,1090,0.7229787234042553,0.2591489361702128,0.4638297872340425
South Dakota,46041,Dewey County,790,1131,1966,-341,0.40183112919633773,0.5752797558494405,-0.17344862665310273
South Dakota,46043,Douglas County,1468,216,1707,1252,0.8599882835383714,0.1265377855887522,0.7334504979496193
South Dakota,46045,Edmunds County,1538,417,1985,1121,0.7748110831234257,0.21007556675062972,0.5647355163727961
South Dakota,46047,Fall River County,2878,1053,4042,1825,0.7120237506185056,0.26051459673428995,0.4515091538842157
South Dakota,46049,Faulk County,964,198,1182,766,0.8155668358714044,0.16751269035532995,0.6480541455160744
South Dakota,46051,Grant County,2618,1056,3745,1562,0.6990654205607477,0.28197596795727636,0.41708945260347136
South Dakota,46053,Gregory County,1771,455,2258,1316,0.7843224092116917,0.20150575730735165,0.5828166519043401
South Dakota,46055,Haakon County,1026,105,1137,921,0.9023746701846965,0.09234828496042216,0.8100263852242744
South Dakota,46057,Hamlin County,2372,647,3083,1725,0.7693804735647097,0.20986052546221212,0.5595199481024976
South Dakota,46059,Hand County,1433,373,1836,1060,0.7805010893246187,0.20315904139433552,0.5773420479302832
South Dakota,46061,Hanson County,1793,557,2388,1236,0.7508375209380235,0.233249581239531,0.5175879396984925
South Dakota,46063,Harding County,748,49,813,699,0.9200492004920049,0.06027060270602706,0.8597785977859779
South Dakota,46065,Hughes County,5522,2953,8723,2569,0.6330390920554855,0.3385303221368795,0.294508769918606
South Dakota,46067,Hutchinson County,2944,762,3767,2182,0.7815237589593841,0.20228298380674276,0.5792407751526414
South Dakota,46069,Hyde County,564,136,710,428,0.7943661971830986,0.19154929577464788,0.6028169014084508
South Dakota,46071,Jackson County,738,359,1115,379,0.6618834080717488,0.3219730941704036,0.33991031390134524
South Dakota,46073,Jerauld County,721,270,1006,451,0.7166998011928429,0.268389662027833,0.44831013916500995
South Dakota,46075,Jones County,498,90,599,408,0.8313856427378965,0.15025041736227046,0.681135225375626
South Dakota,46077,Kingsbury County,1904,819,2779,1085,0.6851385390428212,0.2947103274559194,0.3904282115869018
South Dakota,46079,Lake County,3681,2068,5873,1613,0.6267665588285374,0.3521198705942449,0.2746466882342925
South Dakota,46081,Lawrence County,8753,4537,13828,4216,0.6329910326873012,0.32810240092565807,0.3048886317616431
South Dakota,46083,Lincoln County,19617,11981,32396,7636,0.60553772070626,0.36982960859365355,0.23570811211260645
South Dakota,46085,Lyman County,1042,525,1597,517,0.6524733876017533,0.3287413901064496,0.32373199749530374
South Dakota,46087,McCook County,2068,769,2900,1299,0.713103448275862,0.26517241379310347,0.44793103448275856
South Dakota,46089,McPherson County,1075,222,1324,853,0.8119335347432024,0.16767371601208458,0.6442598187311178
South Dakota,46091,Marshall County,1287,858,2178,429,0.5909090909090909,0.3939393939393939,0.19696969696969702
South Dakota,46093,Meade County,9875,3285,13670,6590,0.7223847841989759,0.2403072421360644,0.48207754206291153
South Dakota,46095,Mellette County,449,298,769,151,0.5838751625487646,0.38751625487646296,0.19635890767230163
South Dakota,46097,Miner County,787,320,1138,467,0.6915641476274165,0.281195079086116,0.41036906854130045
South Dakota,46099,Minnehaha County,49249,40482,92326,8767,0.5334250373675887,0.43846803717262745,0.09495700019496128
South Dakota,46101,Moody County,1951,1179,3206,772,0.6085464753587024,0.367747972551466,0.24079850280723641
South Dakota,46102,Oglala Lakota County,297,2829,3200,-2532,0.0928125,0.8840625,-0.79125
South Dakota,46103,Pennington County,35063,20606,57518,14457,0.6096004728954414,0.35825306860461076,0.25134740429083063
South Dakota,46105,Perkins County,1401,239,1669,1162,0.8394248052726183,0.1431995206710605,0.6962252846015577
South Dakota,46107,Potter County,1139,227,1380,912,0.8253623188405798,0.1644927536231884,0.6608695652173914
South Dakota,46109,Roberts County,2404,1828,4307,576,0.5581611330392384,0.424425354074762,0.13373577896447641
South Dakota,46111,Sanborn County,905,257,1185,648,0.7637130801687764,0.2168776371308017,0.5468354430379747
South Dakota,46115,Spink County,2104,998,3163,1106,0.6651912741068606,0.31552323743281696,0.34966803667404367
South Dakota,46117,Stanley County,1203,421,1652,782,0.7282082324455206,0.25484261501210653,0.47336561743341404
South Dakota,46119,Sully County,726,185,930,541,0.7806451612903226,0.1989247311827957,0.5817204301075269
South Dakota,46121,Todd County,532,1963,2539,-1431,0.20953131153997637,0.773139031114612,-0.5636077195746356
South Dakota,46123,Tripp County,2161,495,2696,1666,0.8015578635014837,0.1836053412462908,0.6179525222551929
South Dakota,46125,Turner County,3290,1139,4548,2151,0.7233948988566403,0.2504397537379068,0.47295514511873354
South Dakota,46127,Union County,5944,2725,8855,3219,0.6712591756070017,0.30773574251835123,0.3635234330886504
South Dakota,46129,Walworth County,1966,565,2580,1401,0.762015503875969,0.2189922480620155,0.5430232558139534
South Dakota,46135,Yankton County,6581,4016,10900,2565,0.6037614678899083,0.36844036697247706,0.2353211009174312
South Dakota,46137,Ziebach County,404,481,906,-77,0.445916114790287,0.5309050772626932,-0.08498896247240623
Tennessee,47001,Anderson County,23184,11741,35570,11443,0.6517852122575204,0.3300815293786899,0.3217036828788305
Tennessee,47003,Bedford County,14354,4453,19088,9901,0.7519907795473596,0.23328792958927075,0.5187028499580888
Tennessee,47005,Benton County,5668,1529,7260,4139,0.7807162534435261,0.2106060606060606,0.5701101928374656
Tennessee,47007,Bledsoe County,4725,971,5758,3754,0.8205974296630775,0.1686349426884335,0.651962486974644
Tennessee,47009,Blount County,47369,17932,66609,29437,0.7111501448753171,0.269212869131799,0.44193727574351815
Tennessee,47011,Bradley County,35204,9851,45865,25353,0.7675569606453723,0.21478251389948763,0.5527744467458846
Tennessee,47013,Campbell County,12331,2441,14933,9890,0.8257550391749816,0.16346347016674478,0.6622915690082368
Tennessee,47015,Cannon County,5190,1261,6557,3929,0.7915205124294646,0.1923135580295867,0.5992069543998779
Tennessee,47017,Carroll County,9205,2559,11905,6646,0.7732045359092818,0.21495170096598068,0.5582528349433011
Tennessee,47019,Carter County,19584,4529,24492,15055,0.7996080352768251,0.1849175240894986,0.6146905111873265
Tennessee,47021,Cheatham County,14438,5514,20260,8924,0.7126357354392893,0.2721618953603159,0.4404738400789734
Tennessee,47023,Chester County,5952,1412,7584,4540,0.7848101265822784,0.18618143459915612,0.5986286919831223
Tennessee,47025,Claiborne County,10604,2202,12945,8402,0.8191579760525299,0.17010428736964078,0.6490536886828892
Tennessee,47027,Clay County,2733,735,3506,1998,0.7795208214489446,0.2096406160867085,0.5698802053622362
Tennessee,47029,Cocke County,12162,2533,14859,9629,0.8184938421158894,0.170469075980887,0.6480247661350024
Tennessee,47031,Coffee County,17883,5705,24282,12178,0.7364714603409933,0.23494769788320566,0.5015237624577876
Tennessee,47033,Crockett County,4673,1382,6114,3291,0.764311416421328,0.2260385999345764,0.5382728164867516
Tennessee,47035,Cumberland County,25168,6728,32279,18440,0.779701973419251,0.2084327271600731,0.5712692462591779
Tennessee,47037,Davidson County,100218,199703,309658,-99485,0.32364091998269057,0.6449147123600876,-0.321273792377397
Tennessee,47039,Decatur County,4229,904,5241,3325,0.8069070788017554,0.17248616676206832,0.6344209120396871
Tennessee,47041,DeKalb County,6672,1750,8513,4922,0.7837425114530717,0.20556795489251733,0.5781745565605544
Tennessee,47043,Dickson County,17643,6106,24323,11537,0.7253628253093779,0.25103811207499077,0.47432471323438713
Tennessee,47045,Dyer County,11768,3158,15079,8610,0.7804231049804363,0.20943033357649712,0.5709927714039392
Tennessee,47047,Fayette County,15690,7027,22984,8663,0.6826487991646363,0.3057344239470936,0.3769143752175427
Tennessee,47049,Fentress County,7441,1214,8729,6227,0.8524458700882117,0.13907664108145262,0.713369229006759
Tennessee,47051,Franklin County,13987,4864,19132,9123,0.7310788208237508,0.2542337445118127,0.47684507631193807
Tennessee,47053,Gibson County,16259,5771,22335,10488,0.7279605999552272,0.2583837027087531,0.4695768972464741
Tennessee,47055,Giles County,9784,3298,13203,6486,0.7410437021888965,0.24979171400439293,0.49125198818450355
Tennessee,47057,Grainger County,8565,1467,10134,7098,0.8451746595618709,0.1447602131438721,0.7004144464179988
Tennessee,47059,Greene County,22259,5199,28087,17060,0.7925018691921529,0.18510342863246343,0.6073984405596895
Tennessee,47061,Grundy County,4802,988,5855,3814,0.8201537147736977,0.16874466268146884,0.6514090520922289
Tennessee,47063,Hamblen County,18811,5500,24631,13311,0.763712394949454,0.22329584669725144,0.5404165482522025
Tennessee,47065,Hamilton County,92108,75522,171113,16586,0.5382875643580558,0.44135746553447136,0.09693009882358444
Tennessee,47067,Hancock County,2372,362,2744,2010,0.8644314868804664,0.13192419825072887,0.7325072886297376
Tennessee,47069,Hardeman County,5760,4180,10063,1580,0.5723939183146179,0.41538308655470535,0.1570108317599126
Tennessee,47071,Hardin County,9559,1775,11538,7784,0.828479805858901,0.15383948691280985,0.6746403189460912
Tennessee,47073,Hawkins County,20405,4083,24824,16322,0.8219867869803416,0.16447792458910732,0.6575088623912342
Tennessee,47075,Haywood County,3343,4012,7439,-669,0.44938835865035626,0.5393198010485281,-0.0899314423981718
Tennessee,47077,Henderson County,9797,2092,12020,7705,0.8150582362728785,0.1740432612312812,0.6410149750415973
Tennessee,47079,Henry County,11239,3548,15047,7691,0.7469262976008507,0.23579451053366118,0.5111317870671895
Tennessee,47081,Hickman County,7577,2130,9832,5447,0.7706468673718471,0.21663954434499594,0.5540073230268512
Tennessee,47083,Houston County,2718,871,3686,1847,0.7373846988605535,0.23629951166576235,0.5010851871947911
Tennessee,47085,Humphreys County,6120,2017,8236,4103,0.7430791646430306,0.24490043710539097,0.4981787275376396
Tennessee,47087,Jackson County,4118,1135,5323,2983,0.7736238962990795,0.21322562464775502,0.5603982716513245
Tennessee,47089,Jefferson County,18651,4654,23616,13997,0.7897611788617886,0.19706978319783197,0.5926913956639567
Tennessee,47091,Johnson County,6468,1246,7801,5222,0.8291244712216382,0.15972311242148443,0.6694013588001538
Tennessee,47093,Knox County,124540,91422,220556,33118,0.56466384954388,0.41450697328569613,0.1501568762581839
Tennessee,47095,Lake County,1492,526,2034,966,0.7335299901671584,0.2586037364798427,0.47492625368731567
Tennessee,47097,Lauderdale County,5674,3193,8965,2481,0.6329057445621863,0.3561628555493586,0.2767428890128277
Tennessee,47099,Lawrence County,15334,3195,18718,12139,0.8192114542151939,0.17069131317448447,0.6485201410407094
Tennessee,47101,Lewis County,4474,1072,5609,3402,0.7976466393296487,0.1911214120164022,0.6065252273132465
Tennessee,47103,Lincoln County,12281,2919,15608,9362,0.7868400820092261,0.187019477191184,0.5998206048180421
Tennessee,47105,Loudon County,21713,6948,29347,14765,0.7398711963744165,0.23675333083449757,0.5031178655399189
Tennessee,47107,McMinn County,18198,4361,22844,13837,0.7966205568201716,0.19090351952372614,0.6057170372964455
Tennessee,47109,McNairy County,9093,1943,11275,7150,0.8064745011086475,0.17232815964523282,0.6341463414634146
Tennessee,47111,Macon County,8096,1307,9487,6789,0.8533783071571625,0.13776747127648362,0.7156108358806789
Tennessee,47113,Madison County,23943,18390,42950,5553,0.5574621653084982,0.4281722933643772,0.12928987194412106
Tennessee,47115,Marion County,9911,3177,13256,6734,0.7476614363307181,0.23966505733252866,0.5079963789981895
Tennessee,47117,Marshall County,11043,3605,14878,7438,0.7422368597929829,0.24230407312810862,0.4999327866648743
Tennessee,47119,Maury County,31464,14418,46657,17046,0.674368261997128,0.30902115438197914,0.3653471076151488
Tennessee,47121,Meigs County,4467,1008,5532,3459,0.8074837310195228,0.1822125813449024,0.6252711496746204
Tennessee,47123,Monroe County,16783,3764,20797,13019,0.8069913929893735,0.18098764244843007,0.6260037505409435
Tennessee,47125,Montgomery County,42187,32472,76758,9715,0.5496104640558639,0.4230438521066208,0.12656661194924307
Tennessee,47127,Moore County,2888,573,3539,2315,0.8160497315625883,0.16191014410850524,0.6541395874540831
Tennessee,47129,Morgan County,6930,1167,8228,5763,0.8422459893048129,0.14183276616431698,0.7004132231404959
Tennessee,47131,Obion County,10790,2589,13521,8201,0.7980178980844612,0.19147992012425116,0.60653797796021
Tennessee,47133,Overton County,7918,2033,10037,5885,0.7888811397828036,0.20255056291720633,0.5863305768655973
Tennessee,47135,Perry County,2775,615,3428,2160,0.80950991831972,0.1794049008168028,0.6301050175029171
Tennessee,47137,Pickett County,2381,525,2931,1856,0.8123507335380417,0.17911975435005117,0.6332309791879904
Tennessee,47139,Polk County,6792,1492,8360,5300,0.8124401913875599,0.1784688995215311,0.6339712918660287
Tennessee,47141,Putnam County,23759,9185,33593,14574,0.7072604411633376,0.2734200577501265,0.43384038341321113
Tennessee,47143,Rhea County,11050,2369,13637,8681,0.8102955195424214,0.17371855980054265,0.6365769597418788
Tennessee,47145,Roane County,19230,6043,25917,13187,0.741984025928927,0.23316741906856503,0.5088166068603619
Tennessee,47147,Robertson County,24536,8692,33717,15844,0.7277041255153187,0.25779280481656136,0.46991132069875735
Tennessee,47149,Rutherford County,81480,59341,143878,22139,0.5663131263987545,0.4124397058619108,0.15387342053684372
Tennessee,47151,Scott County,8004,986,9052,7018,0.8842244807777286,0.10892620415377817,0.7752982766239505
Tennessee,47153,Sequatchie County,5855,1298,7252,4557,0.8073634859349145,0.17898510755653613,0.6283783783783783
Tennessee,47155,Sevier County,33783,8721,43535,25062,0.775996324796141,0.20032158033765934,0.5756747444584817
Tennessee,47157,Shelby County,129815,246105,382055,-116290,0.3397809215950583,0.6441611809817959,-0.3043802593867376
Tennessee,47159,Smith County,7136,1802,9051,5334,0.7884211689316097,0.19909402275991603,0.5893271461716937
Tennessee,47161,Stewart County,4950,1232,6296,3718,0.7862134688691232,0.19567979669631513,0.590533672172808
Tennessee,47163,Sullivan County,55860,17272,74357,38588,0.751240636389311,0.23228478825127427,0.5189558481380367
Tennessee,47165,Sumner County,63454,27680,92630,35774,0.685026449314477,0.2988232753967397,0.3862031739177373
Tennessee,47167,Tipton County,20070,6837,27308,13233,0.7349494653581368,0.25036619305697966,0.4845832723011571
Tennessee,47169,Trousdale County,2936,1012,3998,1924,0.7343671835917959,0.2531265632816408,0.4812406203101551
Tennessee,47171,Unicoi County,6599,1615,8307,4984,0.7943902732635127,0.19441434934392682,0.5999759239195859
Tennessee,47173,Union County,6803,1249,8123,5554,0.8374984611596701,0.15376092576634248,0.6837375353933276
Tennessee,47175,Van Buren County,2342,544,2921,1798,0.8017802122560767,0.1862375898664841,0.6155426223895926
Tennessee,47177,Warren County,11850,3924,16009,7926,0.7402086326441377,0.24511212443000813,0.4950965082141296
Tennessee,47179,Washington County,40444,18638,60203,21806,0.671793764430344,0.30958590103483213,0.36220786339551186
Tennessee,47181,Wayne County,5795,820,6669,4975,0.8689458689458689,0.12295696506222822,0.7459889038836407
Tennessee,47183,Weakley County,10396,3020,13735,7376,0.7568984346559884,0.2198762286130324,0.5370222060429559
Tennessee,47185,White County,9606,2143,11895,7463,0.8075662042875158,0.1801597309794031,0.6274064733081127
Tennessee,47187,Williamson County,86469,50161,139016,36308,0.6220075387005812,0.36082896932727165,0.2611785693733096
Tennessee,47189,Wilson County,50296,22254,74330,28042,0.6766581461052065,0.2993945916857258,0.3772635544194807
Texas,48001,Anderson County,15110,3955,19227,11155,0.7858740313101368,0.20570031726218338,0.5801737140479534
Texas,48003,Andrews County,4943,850,5863,4093,0.8430837455227699,0.14497697424526693,0.698106771277503
Texas,48005,Angelina County,25076,9143,34574,15933,0.7252848961647481,0.26444727251692024,0.4608376236478279
Texas,48007,Aransas County,9239,2916,12290,6323,0.7517493897477624,0.2372660699755899,0.5144833197721725
Texas,48009,Archer County,4300,446,4796,3854,0.896580483736447,0.09299416180150125,0.8035863219349458
Texas,48011,Armstrong County,1035,75,1112,960,0.9307553956834532,0.06744604316546762,0.8633093525179856
Texas,48013,Atascosa County,12039,5876,18118,6163,0.6644773153769732,0.3243183574345954,0.34015895794237777
Texas,48015,Austin County,11447,2951,14554,8496,0.7865191699876323,0.20276212725024048,0.5837570427373918
Texas,48017,Bailey County,1434,409,1860,1025,0.7709677419354839,0.21989247311827956,0.5510752688172044
Texas,48019,Bandera County,10057,2505,12715,7552,0.7909555642941408,0.19701140385371607,0.5939441604404248
Texas,48021,Bastrop County,20516,15474,36665,5042,0.5595527069412246,0.4220373653347879,0.1375153416064367
Texas,48023,Baylor County,1494,183,1702,1311,0.8777908343125734,0.10752056404230317,0.7702702702702703
Texas,48025,Bee County,6006,3288,9420,2718,0.6375796178343949,0.3490445859872611,0.28853503184713375
Texas,48027,Bell County,67893,57014,127375,10879,0.5330166830225711,0.4476074582924436,0.08540922473012752
Texas,48029,Bexar County,308618,448452,768952,-139834,0.4013488488228134,0.5831989512999511,-0.18185010247713773
Texas,48031,Blanco County,5443,1911,7441,3532,0.7314877032656901,0.2568203198494826,0.4746673834162075
Texas,48033,Borden County,397,16,416,381,0.9543269230769231,0.038461538461538464,0.9158653846153847
Texas,48035,Bosque County,7469,1561,9126,5908,0.8184308568923954,0.1710497479728249,0.6473811089195705
Texas,48037,Bowie County,27116,10747,38261,16369,0.7087112203026581,0.2808865424322417,0.4278246778704164
Texas,48039,Brazoria County,90433,62228,154984,28205,0.5834989418262531,0.40151241418469,0.18198652764156303
Texas,48041,Brazos County,47530,35349,85061,12181,0.5587754670177872,0.41557235395774794,0.1432031130600393
Texas,48043,Brewster County,2461,2258,4822,203,0.5103691414350892,0.4682704272086271,0.04209871422646205
Texas,48045,Briscoe County,639,78,725,561,0.8813793103448276,0.10758620689655173,0.7737931034482759
Texas,48047,Brooks County,998,1470,2484,-472,0.40177133655394526,0.5917874396135265,-0.19001610305958128
Texas,48049,Brown County,13698,2107,15969,11591,0.8577869622393387,0.13194313983342726,0.7258438224059114
Texas,48051,Burleson County,6743,1788,8609,4955,0.7832500871181322,0.20768962713439423,0.575560459983738
Texas,48053,Burnet County,18767,5639,24717,13128,0.7592749929198528,0.22814257393696646,0.5311324189828863
Texas,48055,Caldwell County,8031,6672,14973,1359,0.5363654578240834,0.44560208375075133,0.09076337407333207
Texas,48057,Calhoun County,5641,2148,7856,3493,0.7180498981670062,0.27342158859470467,0.4446283095723015
Texas,48059,Callahan County,6012,734,6832,5278,0.879976580796253,0.10743559718969554,0.7725409836065574
Texas,48061,Cameron County,49032,64063,114174,-15031,0.4294497871669557,0.5610997249811691,-0.1316499378142134
Texas,48063,Camp County,3626,1394,5060,2232,0.716600790513834,0.2754940711462451,0.4411067193675889
Texas,48065,Carson County,2779,297,3122,2482,0.8901345291479821,0.09513132607303011,0.795003203074952
Texas,48067,Cass County,11033,2795,13927,8238,0.7922021971709629,0.20068930853737343,0.5915128886335894
Texas,48069,Castro County,1602,466,2083,1136,0.7690830532885262,0.22371579452712434,0.5453672587614019
Texas,48071,Chambers County,17353,3997,21652,13356,0.8014502124515056,0.18460188435248476,0.6168483280990209
Texas,48073,Cherokee County,15101,4210,19508,10891,0.7740926799261841,0.21580889891326635,0.5582837810129178
Texas,48075,Childress County,1943,310,2279,1633,0.8525669153137341,0.13602457218078104,0.7165423431329531
Texas,48077,Clay County,5069,614,5741,4455,0.8829472217383731,0.1069500087092841,0.7759972130290891
Texas,48079,Cochran County,809,177,1000,632,0.809,0.177,0.6320000000000001
Texas,48081,Coke County,1586,178,1779,1408,0.8915120854412592,0.10005621135469364,0.7914558740865655
Texas,48083,Coleman County,3641,451,4124,3190,0.8828806983511154,0.10935984481086324,0.7735208535402521
Texas,48085,Collin County,252318,230945,492216,21373,0.5126164123067921,0.46919441871048484,0.04342199359630727
Texas,48087,Collingsworth County,1048,155,1218,893,0.8604269293924466,0.1272577996715928,0.7331691297208538
Texas,48089,Colorado County,7472,2420,9975,5052,0.7490726817042607,0.24260651629072683,0.5064661654135338
Texas,48091,Comal County,62740,24826,88863,37914,0.7060306314214014,0.27937386763894984,0.4266567637824516
Texas,48093,Comanche County,5177,853,6086,4324,0.8506408149852119,0.14015773907328294,0.7104830759119289
Texas,48095,Concho County,1058,197,1268,861,0.8343848580441641,0.1553627760252366,0.6790220820189274
Texas,48097,Cooke County,15596,3210,18988,12386,0.8213608594902043,0.16905413945649883,0.6523067200337055
Texas,48099,Coryell County,15438,7565,23490,7873,0.6572158365261813,0.3220519369944657,0.3351638995317156
Texas,48101,Cottle County,540,113,662,427,0.8157099697885196,0.17069486404833836,0.6450151057401813
Texas,48103,Crane County,1247,241,1503,1006,0.8296739853626082,0.1603459747172322,0.669328010645376
Texas,48105,Crockett County,1220,344,1574,876,0.7750952986022872,0.21855146124523506,0.5565438373570522
Texas,48107,Crosby County,1396,527,1953,869,0.7147977470558116,0.2698412698412698,0.44495647721454173
Texas,48109,Culberson County,415,438,864,-23,0.48032407407407407,0.5069444444444444,-0.02662037037037035
Texas,48111,Dallam County,1389,197,1609,1192,0.8632691112492231,0.12243629583592293,0.7408328154133001
Texas,48113,Dallas County,307076,598576,921638,-291500,0.3331850466235116,0.6494697484261717,-0.31628470180266005
Texas,48115,Dawson County,2951,808,3789,2143,0.7788334652942729,0.21324887833201372,0.5655845869622591
Texas,48117,Deaf Smith County,3294,1264,4610,2030,0.7145336225596529,0.2741865509761388,0.4403470715835141
Texas,48119,Delta County,2162,403,2592,1759,0.8341049382716049,0.1554783950617284,0.6786265432098766
Texas,48121,Denton County,222480,188695,417964,33785,0.5322946473858993,0.45146232689896737,0.0808323204869319
Texas,48123,DeWitt County,6567,1494,8118,5073,0.8089430894308943,0.18403547671840353,0.6249076127124908
Texas,48125,Dickens County,853,130,988,723,0.8633603238866396,0.13157894736842105,0.7317813765182186
Texas,48127,Dimmit County,1384,2264,3666,-880,0.37752318603382434,0.6175668303327878,-0.24004364429896347
Texas,48129,Donley County,1438,198,1648,1240,0.8725728155339806,0.12014563106796117,0.7524271844660194
Texas,48131,Duval County,2443,2575,5053,-132,0.4834751632693449,0.5095982584603206,-0.026123095190975665
Texas,48133,Eastland County,7237,983,8292,6254,0.8727689339122046,0.11854799807042933,0.7542209358417752
Texas,48135,Ector County,32697,11367,44581,21330,0.733429039276822,0.25497409210201655,0.47845494717480547
Texas,48137,Edwards County,893,168,1066,725,0.8377110694183865,0.1575984990619137,0.6801125703564728
Texas,48139,Ellis County,56717,27565,85493,29152,0.66341103950031,0.32242405811002073,0.34098698139028927
Texas,48141,El Paso County,84331,178126,267215,-93795,0.31559231330576504,0.66660180004865,-0.35100948674288496
Texas,48143,Erath County,13684,2916,16853,10768,0.8119622619118257,0.17302557408176586,0.6389366878300599
Texas,48145,Falls County,4177,1899,6133,2278,0.681069623349095,0.3096363932822436,0.3714332300668514
Texas,48147,Fannin County,12171,2655,15004,9516,0.8111836843508398,0.1769528125833111,0.6342308717675287
Texas,48149,Fayette County,10171,2661,12941,7510,0.7859516266130901,0.20562553125724442,0.5803260953558458
Texas,48151,Fisher County,1448,352,1826,1096,0.7929901423877328,0.1927710843373494,0.6002190580503834
Texas,48153,Floyd County,1584,438,2039,1146,0.7768513977439921,0.2148111819519372,0.562040215792055
Texas,48155,Foard County,445,99,551,346,0.8076225045372051,0.17967332123411978,0.6279491833030852
Texas,48157,Fort Bend County,157718,195552,357514,-37834,0.4411519548884799,0.5469771813131793,-0.10582522642469938
Texas,48159,Franklin County,4161,804,5009,3357,0.83070473148333,0.16051108005589937,0.6701936514274307
Texas,48161,Freestone County,6991,1635,8711,5356,0.8025485018941568,0.18769372058317071,0.6148547813109861
Texas,48163,Frio County,2823,2422,5279,401,0.5347603712824398,0.4587990149649555,0.0759613563174843
Texas,48165,Gaines County,5355,576,5995,4779,0.8932443703085905,0.09608006672226856,0.797164303586322
Texas,48167,Galveston County,93911,58842,155060,35069,0.6056429769121631,0.3794789113891397,0.22616406552302337
Texas,48169,Garza County,1413,231,1653,1182,0.8548094373865699,0.1397459165154265,0.7150635208711433
Texas,48171,Gillespie County,12514,3176,15846,9338,0.7897261138457655,0.2004291303799066,0.5892969834658589
Texas,48173,Glasscock County,611,39,653,572,0.9356814701378254,0.05972434915773354,0.8759571209800919
Texas,48175,Goliad County,3085,877,3988,2208,0.7735707121364093,0.21990972918756269,0.5536609829488466
Texas,48177,Gonzales County,5627,1948,7647,3679,0.7358441218778606,0.25474042108016215,0.4811037007976985
Texas,48179,Gray County,6840,829,7782,6011,0.8789514263685428,0.10652788486250321,0.7724235415060396
Texas,48181,Grayson County,44163,14506,59439,29657,0.7429970221571696,0.24404852033176871,0.49894850182540085
Texas,48183,Gregg County,32493,14796,47982,17697,0.6771914467925472,0.30836563711391773,0.36882580967862943
Texas,48185,Grimes County,9432,2833,12413,6599,0.75984854587932,0.22822847015225972,0.5316200757270604
Texas,48187,Guadalupe County,47553,28805,77592,18748,0.6128595731518713,0.3712367254356119,0.24162284771625941
Texas,48189,Hale County,7177,2279,9584,4898,0.7488522537562604,0.23779215358931552,0.5110601001669449
Texas,48191,Hall County,995,168,1168,827,0.8518835616438356,0.14383561643835616,0.7080479452054794
Texas,48193,Hamilton County,3616,641,4349,2975,0.8314555070131064,0.14739020464474592,0.6840653023683605
Texas,48195,Hansford County,1849,166,2047,1683,0.9032730825598436,0.0810942843185149,0.8221787982413287
Texas,48197,Hardeman County,1330,241,1580,1089,0.8417721518987342,0.15253164556962026,0.6892405063291139
Texas,48199,Hardin County,23858,3474,27635,20384,0.8633254930341958,0.12571015017188347,0.7376153428623123
Texas,48201,Harris County,700630,918193,1640818,-217563,0.4270004351488099,0.5595946655875301,-0.1325942304387202
Texas,48203,Harrison County,21466,7908,29710,13558,0.7225176708179064,0.2661730057219791,0.4563446650959273
Texas,48205,Hartley County,1868,195,2078,1673,0.8989412897016362,0.09384023099133783,0.8051010587102984
Texas,48207,Haskell County,1840,353,2214,1487,0.8310749774164409,0.15943992773261065,0.6716350496838303
Texas,48209,Hays County,47680,59524,109357,-11844,0.43600318223799117,0.5443090062821767,-0.10830582404418554
Texas,48211,Hemphill County,1486,206,1720,1280,0.8639534883720931,0.11976744186046512,0.7441860465116279
Texas,48213,Henderson County,28911,7060,36310,21851,0.7962269347287249,0.19443679427155053,0.6017901404571744
Texas,48215,Hidalgo County,90527,128199,220884,-37672,0.40983955379294107,0.5803906122670723,-0.17055105847413127
Texas,48217,Hill County,11926,2860,14931,9066,0.7987408746902418,0.19154778648449536,0.6071930882057465
Texas,48219,Hockley County,6536,1482,8095,5054,0.8074119827053737,0.18307597282273008,0.6243360098826436
Texas,48221,Hood County,26496,5648,32541,20848,0.8142343505116623,0.1735656556344304,0.6406686948772319
Texas,48223,Hopkins County,12719,3046,15939,9673,0.797979797979798,0.19110358240793024,0.6068762155718678
Texas,48225,Houston County,7060,2314,9437,4746,0.7481191056479813,0.24520504397583978,0.5029140616721416
Texas,48227,Howard County,8054,2069,10240,5985,0.7865234375,0.20205078125,0.58447265625
Texas,48229,Hudspeth County,779,371,1165,408,0.6686695278969957,0.3184549356223176,0.35021459227467816
Texas,48231,Hunt County,29163,8906,38574,20257,0.7560273759527143,0.2308809042360139,0.5251464717167004
Texas,48233,Hutchinson County,7681,965,8771,6716,0.8757268270436667,0.1100216622962034,0.7657051647474633
Texas,48235,Irion County,759,120,889,639,0.8537682789651294,0.13498312710911137,0.718785151856018
Texas,48237,Jack County,3418,331,3782,3087,0.9037546271813856,0.08751983077736647,0.8162347964040191
Texas,48239,Jackson County,5231,1033,6340,4198,0.8250788643533123,0.16293375394321766,0.6621451104100947
Texas,48241,Jasper County,12542,2954,15608,9588,0.8035622757560226,0.18926191696565864,0.6143003587903639
Texas,48243,Jeff Davis County,784,501,1305,283,0.6007662835249042,0.3839080459770115,0.21685823754789274
Texas,48245,Jefferson County,47570,46073,94739,1497,0.5021163406833511,0.48631503393533815,0.015801306748012944
Texas,48247,Jim Hogg County,833,1197,2036,-364,0.40913555992141454,0.5879174852652259,-0.17878192534381138
Texas,48249,Jim Wells County,7453,6119,13669,1334,0.5452483722291316,0.44765527836710806,0.09759309386202353
Texas,48251,Johnson County,54628,16464,72005,38164,0.7586695368377196,0.2286507881397125,0.5300187486980071
Texas,48253,Jones County,5660,999,6741,4661,0.8396380358997182,0.14819759679572764,0.6914404391039906
Texas,48255,Karnes County,3968,1234,5249,2734,0.7559535149552296,0.23509239855210518,0.5208611164031244
Texas,48257,Kaufman County,37624,18405,56703,19219,0.6635275029539883,0.32458600074070154,0.3389415022132868
Texas,48259,Kendall County,20083,6020,26438,14063,0.7596262954837734,0.22770254936076859,0.5319237461230047
Texas,48261,Kenedy County,127,65,194,62,0.654639175257732,0.33505154639175255,0.3195876288659794
Texas,48263,Kent County,411,47,462,364,0.8896103896103896,0.10173160173160173,0.7878787878787878
Texas,48265,Kerr County,20879,6524,27745,14355,0.7525319877455398,0.23514146693097857,0.5173905208145612
Texas,48267,Kimble County,1987,284,2292,1703,0.8669284467713787,0.12390924956369982,0.7430191972076788
Texas,48269,King County,151,8,159,143,0.949685534591195,0.050314465408805034,0.89937106918239
Texas,48271,Kinney County,1144,446,1603,698,0.7136618839675608,0.27822832189644414,0.43543356207111666
Texas,48273,Kleberg County,5504,5314,10944,190,0.5029239766081871,0.485562865497076,0.017361111111111105
Texas,48275,Knox County,1180,265,1456,915,0.8104395604395604,0.1820054945054945,0.6284340659340659
Texas,48277,Lamar County,16760,4458,21418,12302,0.7825193762256046,0.2081426837239705,0.5743766925016341
Texas,48279,Lamb County,3521,840,4408,2681,0.7987749546279492,0.19056261343012704,0.6082123411978222
Texas,48281,Lampasas County,8086,2144,10399,5942,0.7775747668045004,0.20617367054524474,0.5714010962592557
Texas,48283,La Salle County,1335,1052,2406,283,0.5548628428927681,0.4372402327514547,0.11762261014131342
Texas,48285,Lavaca County,8804,1333,10197,7471,0.8633911934882809,0.13072472295773266,0.7326664705305482
Texas,48287,Lee County,6255,1750,8086,4505,0.7735592381894633,0.21642344793470195,0.5571357902547613
Texas,48289,Leon County,7523,1072,8674,6451,0.8673045884251787,0.1235877334563062,0.7437168549688724
Texas,48291,Liberty County,23302,5785,29334,17517,0.7943683098111407,0.19721142701302244,0.5971568827981183
Texas,48293,Limestone County,6789,2213,9095,4576,0.7464540956569544,0.2433205057724024,0.503133589884552
Texas,48295,Lipscomb County,1205,131,1353,1074,0.8906134515890614,0.09682187730968218,0.7937915742793792
Texas,48297,Live Oak County,4199,819,5054,3380,0.8308270676691729,0.16204986149584488,0.668777206173328
Texas,48299,Llano County,10079,2465,12660,7614,0.796129541864139,0.19470774091627172,0.6014218009478672
Texas,48301,Loving County,60,4,66,56,0.9090909090909091,0.06060606060606061,0.8484848484848484
Texas,48303,Lubbock County,78861,40017,120771,38844,0.6529796060312493,0.33134610129915293,0.32163350473209634
Texas,48305,Lynn County,1853,428,2293,1425,0.8081116441343218,0.18665503706934147,0.6214566070649803
Texas,48307,McCulloch County,2904,490,3436,2414,0.8451688009313155,0.14260768335273574,0.7025611175785798
Texas,48309,McLennan County,59543,36688,97771,22855,0.6090047150995694,0.3752441930633828,0.23376052203618664
Texas,48311,McMullen County,460,53,516,407,0.8914728682170543,0.10271317829457365,0.7887596899224807
Texas,48313,Madison County,4169,1088,5297,3081,0.7870492731734944,0.2053992826127997,0.5816499905606947
Texas,48315,Marion County,3470,1339,4864,2131,0.7134046052631579,0.2752878289473684,0.43811677631578944
Texas,48317,Martin County,1857,288,2160,1569,0.8597222222222223,0.13333333333333333,0.726388888888889
Texas,48319,Mason County,1991,457,2474,1534,0.8047696038803557,0.1847210994341148,0.6200485044462409
Texas,48321,Matagorda County,9845,3733,13726,6112,0.7172519306425761,0.27196561270581376,0.4452863179367623
Texas,48323,Maverick County,6881,8332,15346,-1451,0.44839046005473737,0.5429427863938485,-0.09455232633911115
Texas,48325,Medina County,15642,6773,22644,8869,0.690779014308426,0.2991079314608726,0.3916710828475534
Texas,48327,Menard County,823,197,1028,626,0.8005836575875487,0.1916342412451362,0.6089494163424125
Texas,48329,Midland County,45624,12329,58856,33295,0.7751801005844774,0.20947736849259208,0.5657027320918853
Texas,48331,Milam County,7984,2496,10576,5488,0.7549167927382754,0.23600605143721634,0.5189107413010591
Texas,48333,Mills County,2217,271,2505,1946,0.8850299401197604,0.10818363273453094,0.7768463073852295
Texas,48335,Mitchell County,2170,397,2579,1773,0.8414113997673517,0.15393563396665375,0.6874757658006979
Texas,48337,Montague County,8615,1097,9814,7518,0.8778275932341553,0.11177909109435501,0.7660485021398002
Texas,48339,Montgomery County,193382,74377,271451,119005,0.7124011331695224,0.2739978854378875,0.43840324773163486
Texas,48341,Moore County,4359,1062,5508,3297,0.7913943355119826,0.19281045751633988,0.5985838779956427
Texas,48343,Morris County,3872,1669,5587,2203,0.6930374082691964,0.29872919276892784,0.3943082155002685
Texas,48345,Motley County,604,46,652,558,0.9263803680981595,0.0705521472392638,0.8558282208588956
Texas,48347,Nacogdoches County,17378,9000,26763,8378,0.6493292979112955,0.33628516982401074,0.3130441280872847
Texas,48349,Navarro County,13800,5101,19121,8699,0.7217195753360179,0.2667747502745672,0.45494482506145073
Texas,48351,Newton County,4882,1173,6094,3709,0.8011158516573679,0.19248441089596324,0.6086314407614046
Texas,48353,Nolan County,4131,1162,5356,2969,0.7712845407020165,0.2169529499626587,0.5543315907393578
Texas,48355,Nueces County,64617,60925,127314,3692,0.5075404118949998,0.4785412444821465,0.028999167412853244
Texas,48357,Ochiltree County,2812,302,3156,2510,0.8910012674271229,0.09569074778200254,0.7953105196451205
Texas,48359,Oldham County,917,81,1009,836,0.908820614469772,0.0802775024777007,0.8285431119920713
Texas,48361,Orange County,29186,6357,35994,22829,0.8108573651164083,0.17661276879479915,0.6342445963216091
Texas,48363,Palo Pinto County,10179,2178,12485,8001,0.8152983580296356,0.17444933920704847,0.640849018822587
Texas,48365,Panola County,9326,2057,11451,7269,0.8144266876255349,0.17963496637848222,0.6347917212470527
Texas,48367,Parker County,62045,13017,76128,49028,0.8150089323245061,0.17098833543505676,0.6440205968894493
Texas,48369,Parmer County,2135,488,2650,1647,0.8056603773584906,0.18415094339622642,0.6215094339622642
Texas,48371,Pecos County,3215,1382,4668,1833,0.6887317909168809,0.29605826906598115,0.3926735218508997
Texas,48373,Polk County,18573,5387,24181,13186,0.7680823787270998,0.22277821430048386,0.545304164426616
Texas,48375,Potter County,22820,9921,33321,12899,0.6848533957564299,0.29774016386062846,0.38711323189580144
Texas,48377,Presidio County,721,1463,2217,-742,0.3252142534957149,0.6599007668019846,-0.3346865133062697
Texas,48379,Rains County,5155,842,6053,4313,0.8516438129852966,0.1391045762431852,0.7125392367421114
Texas,48381,Randall County,50796,12802,64674,37994,0.7854160868355134,0.19794662460958035,0.5874694622259331
Texas,48383,Reagan County,942,172,1124,770,0.8380782918149466,0.15302491103202848,0.6850533807829182
Texas,48385,Real County,1643,320,1982,1323,0.8289606458123108,0.16145307769929365,0.6675075681130171
Texas,48387,Red River County,4517,1246,5806,3271,0.7779882879779538,0.21460558043403377,0.5633827075439201
Texas,48389,Reeves County,2254,1395,3687,859,0.6113371304583672,0.37835638730675347,0.23298074315161377
Texas,48391,Refugio County,2210,1108,3366,1102,0.6565656565656566,0.32917409387997626,0.3273915626856803
Texas,48393,Roberts County,529,17,550,512,0.9618181818181818,0.03090909090909091,0.9309090909090909
Texas,48395,Robertson County,5646,2374,8099,3272,0.6971231016174836,0.2931226077293493,0.4040004938881343
Texas,48397,Rockwall County,36726,16412,53891,20314,0.6814867046445603,0.304540646861257,0.3769460577833033
Texas,48399,Runnels County,3807,552,4409,3255,0.8634611022907689,0.12519845770015878,0.7382626445906101
Texas,48401,Rusk County,16534,4629,21368,11905,0.7737738674653688,0.21663234743541745,0.5571415200299513
Texas,48403,Sabine County,4784,669,5487,4115,0.8718789866958265,0.12192454893384364,0.7499544377619829
Texas,48405,San Augustine County,3007,980,4002,2027,0.7513743128435783,0.2448775612193903,0.506496751624188
Texas,48407,San Jacinto County,10161,2337,12638,7824,0.8040037980693148,0.18491849976262068,0.6190852983066941
Texas,48409,San Patricio County,16516,8988,25888,7528,0.6379789864029666,0.3471878862793572,0.29079110012360937
Texas,48411,San Saba County,2308,287,2602,2021,0.8870099923136049,0.11029976940814758,0.7767102229054573
Texas,48413,Schleicher County,940,211,1159,729,0.811044003451251,0.182053494391717,0.628990509059534
Texas,48415,Scurry County,4983,818,5869,4165,0.8490373147043789,0.13937638439257113,0.7096609303118078
Texas,48417,Shackelford County,1484,130,1628,1354,0.9115479115479116,0.07985257985257985,0.8316953316953317
Texas,48419,Shelby County,7975,2068,10084,5907,0.7908568028560096,0.2050773502578342,0.5857794525981754
Texas,48421,Sherman County,886,91,991,795,0.8940464177598385,0.09182643794147326,0.8022199798183652
Texas,48423,Smith County,69080,29615,100075,39465,0.6902822882837871,0.29592805395953037,0.39435423432425676
Texas,48425,Somervell County,4105,768,4947,3337,0.8297958358601173,0.15524560339599758,0.6745502324641197
Texas,48427,Starr County,8247,9123,17525,-876,0.4705848787446505,0.5205706134094151,-0.049985734664764636
Texas,48429,Stephens County,3385,397,3800,2988,0.8907894736842106,0.10447368421052632,0.7863157894736843
Texas,48431,Sterling County,584,51,639,533,0.9139280125195618,0.07981220657276995,0.8341158059467918
Texas,48433,Stonewall County,615,116,736,499,0.8355978260869565,0.15760869565217392,0.6779891304347826
Texas,48435,Sutton County,1222,322,1557,900,0.7848426461143224,0.20680796403339757,0.5780346820809248
Texas,48437,Swisher County,1845,478,2355,1367,0.7834394904458599,0.2029723991507431,0.5804670912951169
Texas,48439,Tarrant County,409741,411567,834697,-1826,0.49088591428985606,0.49307353446819624,-0.002187620178340177
Texas,48441,Taylor County,39547,14588,55112,24959,0.717575119756133,0.2646973435912324,0.45287777616490055
Texas,48443,Terrell County,334,119,458,215,0.7292576419213974,0.259825327510917,0.4694323144104804
Texas,48445,Terry County,2812,757,3612,2055,0.778516057585825,0.20957918050941307,0.5689368770764119
Texas,48447,Throckmorton County,806,82,899,724,0.896551724137931,0.09121245828698554,0.8053392658509455
Texas,48449,Titus County,7570,2856,10539,4714,0.7182844672170036,0.2709934528892684,0.44729101432773516
Texas,48451,Tom Green County,32313,12239,45210,20074,0.7147312541473125,0.2707144437071444,0.4440168104401681
Texas,48453,Travis County,161337,435860,610349,-274523,0.2643356505867954,0.7141160221447074,-0.44978037155791195
Texas,48455,Trinity County,5579,1323,6938,4256,0.8041222254251946,0.19068895935428076,0.6134332660709139
Texas,48457,Tyler County,8194,1403,9660,6791,0.84824016563147,0.14523809523809525,0.7030020703933747
Texas,48459,Upshur County,15809,2877,18887,12932,0.8370307618997194,0.15232699740562292,0.6847037644940964
Texas,48461,Upton County,1178,170,1368,1008,0.8611111111111112,0.12426900584795321,0.736842105263158
Texas,48463,Uvalde County,6174,4073,10342,2101,0.5969831754012763,0.3938309804679946,0.20315219493328174
Texas,48465,Val Verde County,8284,6771,15272,1513,0.5424305919329492,0.4433603981141959,0.09907019381875326
Texas,48467,Van Zandt County,22270,3516,25994,18754,0.8567361698853582,0.13526198353466184,0.7214741863506964
Texas,48469,Victoria County,23358,10380,34188,12978,0.6832221832221832,0.3036153036153036,0.3796068796068796
Texas,48471,Walker County,15375,7884,23612,7491,0.6511519566322209,0.33389801795697105,0.31725393867524987
Texas,48473,Waller County,14260,8191,22734,6069,0.6272543327175156,0.3602973519838128,0.26695698073370283
Texas,48475,Ward County,3241,764,4060,2477,0.7982758620689655,0.18817733990147784,0.6100985221674877
Texas,48477,Washington County,12959,4261,17418,8698,0.7440004592949822,0.24463198989551038,0.49936846939947177
Texas,48479,Webb County,25898,41820,68397,-15922,0.3786423381142448,0.6114303258914865,-0.2327879877772417
Texas,48481,Wharton County,11926,4694,16761,7232,0.7115327247777579,0.2800548893264125,0.4314778354513454
Texas,48483,Wheeler County,2159,168,2337,1991,0.9238339751818571,0.07188703465982028,0.8519469405220368
Texas,48485,Wichita County,32069,13161,46030,18908,0.6966978057788399,0.2859222246361069,0.410775581142733
Texas,48487,Wilbarger County,3524,956,4524,2568,0.7789566755083996,0.21131741821396993,0.5676392572944298
Texas,48489,Willacy County,2441,3108,5549,-667,0.43989908091548025,0.5601009190845198,-0.12020183816903951
Texas,48491,Williamson County,139729,143795,289312,-4066,0.48296994248423847,0.49702397411790733,-0.014054031633668862
Texas,48493,Wilson County,18463,6350,25013,12113,0.7381361691920202,0.25386798864590415,0.48426818054611603
Texas,48495,Winkler County,1753,358,2126,1395,0.8245531514581373,0.16839134524929444,0.6561618062088429
Texas,48497,Wise County,27032,4973,32362,22059,0.8353006612693901,0.1536678820839256,0.6816327791854645
Texas,48499,Wood County,19049,3509,22779,15540,0.8362526888801088,0.1540453926862461,0.6822072961938628
Texas,48501,Yoakum County,2174,420,2631,1754,0.8263017863930064,0.15963511972633979,0.6666666666666666
Texas,48503,Young County,7110,1034,8239,6076,0.8629688068940405,0.12550066755674233,0.7374681393372982
Texas,48505,Zapata County,2033,1826,3874,207,0.5247805885389778,0.47134744450180693,0.053433144037170865
Texas,48507,Zavala County,1490,2864,4379,-1374,0.3402603334094542,0.6540306005937429,-0.31377026718428863
Utah,49001,Beaver County,2695,357,3100,2338,0.8693548387096774,0.11516129032258064,0.7541935483870968
Utah,49003,Box Elder County,21548,4473,27027,17075,0.7972767972767972,0.1655011655011655,0.6317756317756318
Utah,49005,Cache County,38032,16650,57571,21382,0.6606103767521843,0.2892081082489448,0.3714022685032395
Utah,49007,Carbon County,6693,2392,9369,4301,0.7143772014089017,0.255310065108336,0.4590671363005657
Utah,49009,Daggett County,496,111,619,385,0.8012924071082391,0.17932148626817448,0.6219709208400647
Utah,49011,Davis County,104135,57411,169895,46724,0.6129374025133171,0.33792048029665384,0.27501692221666324
Utah,49013,Duchesne County,7513,843,8524,6670,0.8813937118723604,0.09889723134678555,0.7824964805255749
Utah,49015,Emery County,4207,572,4865,3635,0.8647482014388489,0.11757451181911614,0.7471736896197327
Utah,49017,Garfield County,2158,514,2732,1644,0.7898975109809663,0.18814055636896046,0.6017569546120058
Utah,49019,Grand County,2248,2806,5185,-558,0.43355834136933463,0.5411764705882353,-0.10761812921890063
Utah,49021,Iron County,18989,4892,24890,14097,0.7629168340699076,0.196544797107272,0.5663720369626356
Utah,49023,Juab County,5087,645,5866,4442,0.867200818274804,0.10995567678145243,0.7572451414933515
Utah,49025,Kane County,2998,1083,4180,1915,0.7172248803827751,0.2590909090909091,0.458133971291866
Utah,49027,Millard County,5404,624,6160,4780,0.8772727272727273,0.1012987012987013,0.775974025974026
Utah,49029,Morgan County,5181,1086,6512,4095,0.7956081081081081,0.16676904176904178,0.6288390663390664
Utah,49031,Piute County,773,86,871,687,0.8874856486796785,0.09873708381171067,0.7887485648679678
Utah,49033,Rich County,1157,180,1363,977,0.8488628026412326,0.13206162876008803,0.7168011738811446
Utah,49035,Salt Lake County,230174,289906,541175,-59732,0.4253226775072758,0.5356973252644708,-0.11037464775719497
Utah,49037,San Juan County,3535,3113,6878,422,0.5139575457981972,0.4526025007269555,0.061355045071241676
Utah,49039,Sanpete County,10459,1794,12631,8665,0.8280421185971024,0.14203150977753148,0.686010608819571
Utah,49041,Sevier County,9052,1084,10363,7968,0.8734922319791566,0.10460291421403069,0.7688893177651259
Utah,49043,Summit County,10252,15244,26088,-4992,0.3929776142287642,0.5843299601349279,-0.19135234590616368
Utah,49045,Tooele County,21014,8943,31518,12071,0.6667301224696999,0.2837426232628974,0.3829874992068025
Utah,49047,Uintah County,13261,1663,15307,11598,0.8663356634219638,0.10864310446201085,0.7576925589599529
Utah,49049,Utah County,192812,76033,284480,116779,0.6777699662542183,0.2672701068616423,0.41049985939257594
Utah,49051,Wasatch County,10795,6187,17581,4608,0.6140151299698539,0.3519139980660941,0.2621011319037598
Utah,49053,Washington County,67294,20530,90476,46764,0.7437773553207481,0.22691100402316636,0.5168663512975817
Utah,49055,Wayne County,1229,365,1621,864,0.7581739666872301,0.22516964836520667,0.5330043183220234
Utah,49057,Weber County,65949,40695,111442,25254,0.5917786830817825,0.3651675310924068,0.2266111519893757
Vermont,50001,Addison County,6292,14967,22022,-8675,0.2857142857142857,0.6796385432749069,-0.3939242575606212
Vermont,50003,Bennington County,7114,12705,20462,-5591,0.34766884957482164,0.6209070472094614,-0.2732381976346398
Vermont,50005,Caledonia County,6551,9011,16169,-2460,0.40515801843032967,0.5573010081019234,-0.15214298967159373
Vermont,50007,Chittenden County,21017,74961,98915,-53944,0.21247535763028863,0.7578324824344134,-0.5453571248041247
Vermont,50009,Essex County,1773,1405,3288,368,0.5392335766423357,0.42731143552311435,0.11192214111922139
Vermont,50011,Franklin County,11274,13611,25830,-2337,0.43646922183507547,0.526945412311266,-0.09047619047619054
Vermont,50013,Grand Isle County,1810,2905,4851,-1095,0.373118944547516,0.5988455988455988,-0.22572665429808286
Vermont,50015,Lamoille County,4163,10240,14915,-6077,0.2791149849145156,0.6865571572242709,-0.4074421723097553
Vermont,50017,Orange County,6187,10304,17122,-4117,0.3613479733675972,0.6017988552739166,-0.2404508819063194
Vermont,50019,Orleans County,6512,7147,14096,-635,0.4619750283768445,0.5070232690124858,-0.045048240635641335
Vermont,50021,Rutland County,14672,18230,33970,-3558,0.4319105092728878,0.5366499852811304,-0.10473947600824257
Vermont,50023,Washington County,8928,25191,35307,-16263,0.25286770328829977,0.7134845781289829,-0.46061687484068314
Vermont,50025,Windham County,6440,18767,26035,-12327,0.24735932398694066,0.7208373343575956,-0.4734780103706549
Vermont,50027,Windsor County,9971,23376,34446,-13405,0.2894675724322127,0.6786274168263369,-0.38915984439412415
Virginia,51001,Accomack County,9172,7578,16962,1594,0.5407381205046574,0.4467633533781394,0.09397476712651803
Virginia,51003,Albemarle County,20804,42466,64657,-21662,0.321759438266545,0.6567889014337195,-0.33502946316717447
Virginia,51005,Alleghany County,5859,2243,8203,3616,0.7142508838229916,0.27343654760453495,0.44081433621845667
Virginia,51007,Amelia County,5390,2411,7893,2979,0.6828835677182313,0.3054605346509565,0.3774230330672748
Virginia,51009,Amherst County,11041,5672,17005,5369,0.6492796236401058,0.3335489561893561,0.31573066745074974
Virginia,51011,Appomattox County,6702,2418,9268,4284,0.7231333621061717,0.26089771255934396,0.4622356495468278
Virginia,51013,Arlington County,22318,105344,130699,-83026,0.17075876632567963,0.8060046366077782,-0.6352458702820986
Virginia,51015,Augusta County,30714,10840,42278,19874,0.7264771275840863,0.2563981266852737,0.47007900089881266
Virginia,51017,Bath County,1834,646,2501,1188,0.7333066773290684,0.258296681327469,0.4750099960015994
Virginia,51019,Bedford County,35600,12176,48669,23424,0.7314717787503339,0.250179785900676,0.48129199284965785
Virginia,51021,Bland County,2903,532,3479,2371,0.8344351825237137,0.1529175050301811,0.6815176774935326
Virginia,51023,Botetourt County,15099,5700,21120,9399,0.7149147727272728,0.26988636363636365,0.4450284090909091
Virginia,51025,Brunswick County,3357,4552,7948,-1195,0.4223704076497232,0.5727226975339708,-0.15035228988424754
Virginia,51027,Buchanan County,8311,1587,9953,6724,0.8350246156937606,0.15944941223751632,0.6755752034562443
Virginia,51029,Buckingham County,4544,3471,8126,1073,0.5591927147428009,0.42714742800886046,0.1320452867339404
Virginia,51031,Campbell County,21245,8070,29892,13175,0.7107252776662653,0.2699718988358089,0.44075337883045634
Virginia,51033,Caroline County,8336,7657,16288,679,0.5117878192534381,0.4701006876227898,0.0416871316306483
Virginia,51035,Carroll County,12659,2842,15651,9817,0.8088301067024471,0.18158584116030924,0.627244265542138
Virginia,51036,Charles City County,1761,2624,4441,-863,0.3965323125422202,0.5908579148840352,-0.19432560234181495
Virginia,51037,Charlotte County,3815,2317,6191,1498,0.6162170893232111,0.3742529478274915,0.24196414149571954
Virginia,51041,Chesterfield County,93326,106935,203884,-13609,0.4577406760707069,0.5244894155500186,-0.0667487394793117
Virginia,51043,Clarke County,5192,3920,9337,1272,0.5560672592909929,0.419835064795973,0.1362321944950199
Virginia,51045,Craig County,2536,587,3169,1949,0.8002524455664247,0.18523193436415272,0.615020511202272
Virginia,51047,Culpeper County,16012,10617,27116,5395,0.5905000737571914,0.39154005015489013,0.19896002360230125
Virginia,51049,Cumberland County,3019,2227,5310,792,0.5685499058380414,0.4193973634651601,0.14915254237288134
Virginia,51051,Dickenson County,5748,1503,7303,4245,0.7870738052854991,0.20580583321922497,0.5812679720662741
Virginia,51053,Dinwiddie County,8695,6224,15092,2471,0.5761330506228466,0.41240392260800424,0.16372912801484235
Virginia,51057,Essex County,3075,3038,6178,37,0.4977338944642279,0.4917449012625445,0.00598899320168339
Virginia,51059,Fairfax County,168401,419943,600823,-251542,0.280283877281662,0.6989462786877333,-0.4186624014060713
Virginia,51061,Fauquier County,25106,17565,43661,7541,0.5750211859554293,0.40230411580128717,0.17271707015414212
Virginia,51063,Floyd County,6225,3004,9408,3221,0.6616709183673469,0.3193027210884354,0.34236819727891155
Virginia,51065,Fluvanna County,8155,7414,15840,741,0.5148358585858586,0.46805555555555556,0.046780303030303005
Virginia,51067,Franklin County,20895,8381,29702,12514,0.7034879806073665,0.28216955087199513,0.42131842973537137
Virginia,51069,Frederick County,30558,17207,48703,13351,0.6274356815801901,0.35330472455495554,0.2741309570252346
Virginia,51071,Giles County,6876,2156,9176,4720,0.7493461203138623,0.23496076721883175,0.5143853530950305
Virginia,51073,Gloucester County,14875,6964,22282,7911,0.6675792119199354,0.31253926936540705,0.35503994255452836
Virginia,51075,Goochland County,9966,6685,16950,3281,0.5879646017699115,0.3943952802359882,0.1935693215339233
Virginia,51077,Grayson County,6529,1535,8131,4994,0.8029762636822039,0.18878366744557865,0.6141925962366253
Virginia,51079,Greene County,6866,4163,11311,2703,0.6070197153213686,0.3680488020511007,0.23897091327026787
Virginia,51081,Greensville County,1914,2627,4574,-713,0.4184521206821163,0.5743331875819851,-0.15588106689986886
Virginia,51083,Halifax County,10418,7666,18248,2752,0.5709118807540552,0.4201008329679965,0.1508110477860587
Virginia,51085,Hanover County,44318,25307,70967,19011,0.6244874378232136,0.356602364479265,0.26788507334394857
Virginia,51087,Henrico County,63440,116572,183152,-53132,0.3463789639206779,0.636476806150083,-0.29009784222940505
Virginia,51089,Henry County,16725,9127,26105,7598,0.6406818617123157,0.3496265083317372,0.2910553533805785
Virginia,51091,Highland County,1092,417,1533,675,0.7123287671232876,0.2720156555772994,0.44031311154598823
Virginia,51093,Isle of Wight County,13707,9399,23456,4308,0.5843707366984994,0.4007077080491132,0.18366302864938616
Virginia,51095,James City County,23153,25553,49622,-2400,0.4665874007496675,0.5149530450203539,-0.0483656442706864
Virginia,51097,King and Queen County,2450,1590,4115,860,0.5953827460510328,0.3863912515188335,0.20899149453219928
Virginia,51099,King George County,8446,5404,14224,3042,0.593785151856018,0.3799212598425197,0.2138638920134983
Virginia,51101,King William County,7320,3260,10736,4060,0.6818181818181818,0.3036512667660209,0.3781669150521609
Virginia,51103,Lancaster County,3697,3368,7152,329,0.5169183445190156,0.470917225950783,0.046001118568232635
Virginia,51105,Lee County,8365,1489,9946,6876,0.8410416247737784,0.1497084254976875,0.6913331992760909
Virginia,51107,Loudoun County,82088,138372,224862,-56284,0.3650594586902189,0.6153640899751848,-0.2503046312849659
Virginia,51109,Louisa County,13294,8269,21915,5025,0.6066164727355693,0.3773214693132558,0.22929500342231351
Virginia,51111,Lunenburg County,3537,2418,6000,1119,0.5895,0.403,0.1865
Virginia,51113,Madison County,5300,2698,8129,2602,0.651986714232993,0.33189814245294624,0.3200885717800468
Virginia,51115,Mathews County,3901,1825,5826,2076,0.6695846206659801,0.31325094404394094,0.3563336766220392
Virginia,51117,Mecklenburg County,9266,6803,16204,2463,0.5718341150333252,0.4198346087385831,0.15199950629474207
Virginia,51119,Middlesex County,4196,2491,6785,1705,0.6184229918938836,0.3671333824613117,0.2512896094325719
Virginia,51121,Montgomery County,20629,23218,45037,-2589,0.4580456069454005,0.5155316739569688,-0.057486067011568276
Virginia,51125,Nelson County,4812,4327,9316,485,0.5165306998711894,0.4644697294976385,0.0520609703735509
Virginia,51127,New Kent County,9631,4621,14463,5010,0.6659061052340455,0.31950494364931203,0.34640116158473344
Virginia,51131,Northampton County,2955,3667,6732,-712,0.43894830659536543,0.5447118241235889,-0.10576351752822344
Virginia,51133,Northumberland County,4485,3252,7815,1233,0.5738963531669866,0.4161228406909789,0.15777351247600774
Virginia,51135,Nottoway County,4027,2971,7078,1056,0.5689460299519639,0.4197513421870585,0.14919468776490535
Virginia,51137,Orange County,12426,7995,20742,4431,0.5990743419149551,0.3854498119757015,0.21362452993925363
Virginia,51139,Page County,9345,3007,12514,6338,0.7467636247402909,0.2402908742208726,0.5064727505194183
Virginia,51141,Patrick County,7485,1954,9534,5531,0.7850849590937696,0.20495070274805957,0.58013425634571
Virginia,51143,Pittsylvania County,23751,10115,34227,13636,0.6939258480147252,0.295526923189295,0.3983989248254302
Virginia,51145,Powhatan County,14055,5320,19730,8735,0.7123669538773442,0.26964014191586416,0.44272681196148
Virginia,51147,Prince Edward County,4434,4973,9574,-539,0.4631293085439733,0.5194276164612492,-0.05629830791727597
Virginia,51149,Prince George County,10103,7103,17432,3000,0.5795663148233134,0.40746902248737954,0.1720972923359339
Virginia,51153,Prince William County,81222,142863,228056,-61641,0.356149366822184,0.6264382432385028,-0.2702888764163188
Virginia,51155,Pulaski County,12127,4925,17376,7202,0.6979166666666666,0.28343692449355434,0.4144797421731123
Virginia,51157,Rappahannock County,2812,2096,4978,716,0.5648854961832062,0.42105263157894735,0.14383286460425881
Virginia,51159,Richmond County,2547,1513,4102,1034,0.62091662603608,0.36884446611409066,0.25207215992198934
Virginia,51161,Roanoke County,34268,21801,57184,12467,0.599258533855624,0.3812430050363738,0.21801552881925018
Virginia,51163,Rockbridge County,8088,4086,12373,4002,0.6536814030550392,0.3302351895255799,0.3234462135294593
Virginia,51165,Rockingham County,30349,12644,43811,17705,0.692725571203579,0.2886033188012143,0.4041222524023647
Virginia,51167,Russell County,10879,2373,13386,8506,0.8127147766323024,0.17727476467951592,0.6354400119527865
Virginia,51169,Scott County,9063,1692,10869,7371,0.8338393596467016,0.15567209494893736,0.6781672646977643
Virginia,51171,Shenandoah County,16463,6836,23684,9627,0.6951106232055396,0.28863367674379325,0.40647694646174637
Virginia,51173,Smyth County,10963,3008,14136,7955,0.7755376344086021,0.21279003961516696,0.5627475947934352
Virginia,51175,Southampton County,5730,3969,9786,1761,0.5855303494788473,0.4055793991416309,0.17995095033721642
Virginia,51177,Spotsylvania County,39411,34307,75317,5104,0.5232683192373567,0.45550141402339445,0.06776690521396228
Virginia,51179,Stafford County,37636,40245,79625,-2609,0.4726656200941915,0.5054317111459968,-0.032766091051805335
Virginia,51181,Surry County,2025,2397,4471,-372,0.45291881010959517,0.5361216730038023,-0.08320286289420714
Virginia,51183,Sussex County,2219,2827,5088,-608,0.436124213836478,0.55562106918239,-0.11949685534591198
Virginia,51185,Tazewell County,16731,3205,20134,13526,0.8309824178007351,0.15918347074600178,0.6717989470547333
Virginia,51187,Warren County,14069,6603,21147,7466,0.6652953137560883,0.31224287132926654,0.35305244242682177
Virginia,51191,Washington County,21679,6617,28685,15062,0.7557608506187903,0.23067805473243855,0.5250827958863518
Virginia,51193,Westmoreland County,5318,4501,9933,817,0.5353870935266284,0.45313601127554615,0.08225108225108224
Virginia,51195,Wise County,13366,3110,16615,10256,0.8044538068010834,0.1871802588022871,0.6172735479987963
Virginia,51197,Wythe County,11733,3143,15072,8590,0.7784633757961783,0.20853237791932058,0.5699309978768577
Virginia,51199,York County,20241,17683,38787,2558,0.5218501044164282,0.4559001727382886,0.06594993167813962
Virginia,51510,Alexandria city,14544,66240,82508,-51696,0.17627381587240026,0.8028312406069714,-0.6265574247345711
Virginia,51520,Bristol city,5347,2313,7806,3034,0.6849859082756854,0.2963105303612606,0.3886753779144248
Virginia,51530,Buena Vista city,1863,825,2776,1038,0.6711095100864554,0.29719020172910665,0.3739193083573487
Virginia,51540,Charlottesville city,3094,20696,24205,-17602,0.12782482958066516,0.8550299524891551,-0.7272051229084899
Virginia,51550,Chesapeake city,58180,66377,127108,-8197,0.45772099317116155,0.5222094596720899,-0.06448846650092832
Virginia,51570,Colonial Heights city,6007,2972,9146,3035,0.6567898534878636,0.32495079816313144,0.3318390553247321
Virginia,51580,Covington city,1580,964,2603,616,0.6069919323857088,0.37034191317710335,0.23665001920860546
Virginia,51590,Danville city,7428,11710,19389,-4282,0.3831038217546031,0.6039506936922998,-0.2208468719376967
Virginia,51595,Emporia city,754,1612,2381,-858,0.31667366652666945,0.6770264594708106,-0.3603527929441412
Virginia,51600,Fairfax city,4007,9174,13483,-5167,0.29718905288140623,0.6804123711340206,-0.3832233182526144
Virginia,51610,Falls Church city,1490,7146,8819,-5656,0.1689533960766527,0.8102959519219867,-0.641342555845334
Virginia,51620,Franklin city,1487,2525,4058,-1038,0.36643666830951205,0.622227698373583,-0.255791030064071
Virginia,51630,Fredericksburg city,4037,8517,12862,-4480,0.313870315658529,0.6621831752449074,-0.3483128595863784
Virginia,51640,Galax city,1838,777,2638,1061,0.6967399545109931,0.29454131918119786,0.4021986353297953
Virginia,51650,Hampton city,18430,46220,65901,-27790,0.2796619171181014,0.7013550628973764,-0.42169314577927497
Virginia,51660,Harrisonburg city,5591,11022,17086,-5431,0.3272269694486714,0.6450895469975418,-0.31786257754887043
Virginia,51670,Hopewell city,4020,5430,9608,-1410,0.4184013322231474,0.5651540383014155,-0.14675270607826812
Virginia,51678,Lexington city,906,1791,2762,-885,0.3280231716147719,0.6484431571325127,-0.32041998551774076
Virginia,51680,Lynchburg city,17097,18048,36363,-951,0.47017572807524133,0.4963286857520007,-0.026152957676759347
Virginia,51683,Manassas city,6256,10356,16968,-4100,0.3686940122583687,0.6103253182461104,-0.24163130598774168
Virginia,51685,Manassas Park city,1979,3992,6087,-2013,0.3251191062920979,0.6558238869722359,-0.33070478068013803
Virginia,51690,Martinsville city,2165,3766,6013,-1601,0.36005321802760687,0.6263096623981373,-0.2662564443705305
Virginia,51700,Newport News city,26377,53099,81203,-26722,0.3248279004470278,0.6539044123985567,-0.32907651195152887
Virginia,51710,Norfolk city,23443,64440,89881,-40997,0.26082264327277177,0.7169479645308797,-0.45612532125810795
Virginia,51720,Norton city,1109,464,1601,645,0.6926920674578388,0.28981886321049344,0.4028732042473454
Virginia,51730,Petersburg city,1584,12389,14118,-10805,0.11219719507012324,0.8775322283609577,-0.7653350332908344
Virginia,51735,Poquoson city,5605,2054,7857,3551,0.7133766068473972,0.2614229349624539,0.45195367188494334
Virginia,51740,Portsmouth city,12755,30948,44582,-18193,0.2861020142658472,0.6941815082320218,-0.40807949396617466
Virginia,51750,Radford city,2786,3358,6320,-572,0.4408227848101266,0.5313291139240506,-0.09050632911392398
Virginia,51760,Richmond city,16603,92175,111159,-75572,0.14936262470875053,0.8292176072112919,-0.6798549825025414
Virginia,51770,Roanoke city,15607,26773,43323,-11166,0.3602474436211712,0.6179858273896083,-0.25773838376843705
Virginia,51775,Salem city,7683,5148,13051,2535,0.5886905217990959,0.3944525323729982,0.19423798942609766
Virginia,51790,Staunton city,5695,6981,12990,-1286,0.4384141647421093,0.5374133949191686,-0.0989992301770593
Virginia,51800,Suffolk city,20082,28676,49642,-8594,0.4045364812054309,0.5776560170823093,-0.1731195358768784
Virginia,51810,Virginia Beach city,105087,117393,227561,-12306,0.4617970566133916,0.5158748643220938,-0.05407780770870224
Virginia,51820,Waynesboro city,5507,4961,10717,546,0.5138564896892787,0.46290939628627414,0.05094709340300452
Virginia,51830,Williamsburg city,1963,4790,6883,-2827,0.28519540897864304,0.6959174778439634,-0.41072206886532037
Virginia,51840,Winchester city,5221,6610,12106,-1389,0.43127374855443584,0.5460102428547827,-0.11473649430034688
Washington,53001,Adams County,3907,1814,5862,2093,0.6664960764244285,0.3094506994199932,0.35704537700443534
Washington,53003,Asotin County,7319,4250,11951,3069,0.6124173709313028,0.35561877667140823,0.25679859425989454
Washington,53005,Benton County,60365,38706,103033,21659,0.5858802519581106,0.3756660487416653,0.21021420321644524
Washington,53007,Chelan County,22746,19349,43306,3397,0.5252389969057405,0.44679721054819194,0.07844178635754856
Washington,53009,Clallam County,23062,24721,49264,-1659,0.4681308866515102,0.5018065930496914,-0.03367570639818124
Washington,53011,Clark County,126303,140324,275403,-14021,0.4586115619655559,0.5095224089788419,-0.05091084701328602
Washington,53013,Columbia County,1754,668,2495,1086,0.7030060120240481,0.26773547094188377,0.43527054108216434
Washington,53015,Cowlitz County,34424,23938,60280,10486,0.5710683477106835,0.3971134704711347,0.17395487723954878
Washington,53017,Douglas County,12955,7811,21308,5144,0.607987610287216,0.3665759339215318,0.24141167636568422
Washington,53019,Ferry County,2771,1486,4367,1285,0.6345317151362492,0.34027936798717656,0.2942523471490726
Washington,53021,Franklin County,18039,13340,32404,4699,0.5566905320330824,0.4116775706702876,0.1450129613627948
Washington,53023,Garfield County,1069,366,1489,703,0.7179314976494291,0.2458025520483546,0.4721289456010745
Washington,53025,Grant County,24764,11819,37680,12945,0.6572186836518047,0.31366772823779193,0.34355095541401276
Washington,53027,Grays Harbor County,19877,17354,38441,2523,0.5170781197159283,0.45144507166827086,0.06563304804765746
Washington,53029,Island County,22746,29213,53925,-6467,0.42180806675938803,0.541733889661567,-0.11992582290217896
Washington,53031,Jefferson County,6931,17204,24792,-10273,0.27956598902871893,0.6939335269441755,-0.4143675379154566
Washington,53033,King County,269167,907310,1210507,-638143,0.22235889590064328,0.7495289163961877,-0.5271700204955444
Washington,53035,Kitsap County,61563,90277,158672,-28714,0.3879890591912877,0.5689535645860644,-0.1809645053947767
Washington,53037,Kittitas County,14105,11421,26364,2684,0.5350098619329389,0.43320436959490216,0.10180549233803671
Washington,53039,Klickitat County,7237,5959,13560,1278,0.5337020648967552,0.4394542772861357,0.09424778761061953
Washington,53041,Lewis County,29391,14520,45309,14871,0.6486790703833676,0.32046613255644574,0.32821293782692185
Washington,53043,Lincoln County,5150,1713,7033,3437,0.7322621925209726,0.24356604578416038,0.48869614673681216
Washington,53045,Mason County,18710,17269,37303,1441,0.5015682384794788,0.462938637643085,0.03862960083639383
Washington,53047,Okanogan County,11840,8900,21282,2940,0.5563386899727469,0.4181937787801898,0.13814491119255712
Washington,53049,Pacific County,6953,6794,14064,159,0.4943828213879408,0.4830773606370876,0.011305460750853202
Washington,53051,Pend Oreille County,5728,2593,8553,3135,0.6697065357184614,0.3031684788962937,0.36653805682216767
Washington,53053,Pierce County,197730,249506,464081,-51776,0.42606786315319956,0.537634593960968,-0.11156673080776847
Washington,53055,San Juan County,3057,9725,13197,-6668,0.23164355535348943,0.7369099037660074,-0.5052663484125179
Washington,53057,Skagit County,32762,38252,73423,-5490,0.4462089535976465,0.5209811639404546,-0.07477221034280807
Washington,53059,Skamania County,3885,3192,7312,693,0.5313183807439825,0.4365426695842451,0.09477571115973743
Washington,53061,Snohomish County,166428,256728,438796,-90300,0.3792833116072161,0.5850737016745823,-0.20579039006736616
Washington,53063,Spokane County,148576,135765,295430,12811,0.5029143959652033,0.4595504857326609,0.04336391023254238
Washington,53065,Stevens County,19808,7839,28430,11969,0.6967288075976081,0.2757298628209638,0.42099894477664435
Washington,53067,Thurston County,65277,96608,168134,-31331,0.3882439006982526,0.5745893156648864,-0.18634541496663376
Washington,53069,Wahkiakum County,1741,1165,2981,576,0.5840322039584033,0.39080845353908084,0.19322375041932244
Washington,53071,Walla Walla County,16400,13690,31261,2710,0.5246153354019385,0.4379258501007645,0.08668948530117399
Washington,53073,Whatcom County,50489,83660,138620,-33171,0.3642259414225941,0.6035204155244553,-0.23929447410186122
Washington,53075,Whitman County,9067,11184,21126,-2117,0.4291867840575594,0.529395058222096,-0.10020827416453659
Washington,53077,Yakima County,50555,43179,96193,7376,0.5255579927853378,0.4488788165459025,0.07667917623943526
West Virginia,54001,Barbour County,5116,1457,6677,3659,0.7662123708252209,0.21821177175378165,0.5480005990714392
West Virginia,54003,Berkeley County,33279,17186,51535,16093,0.6457553119239352,0.3334820995439992,0.312273212379936
West Virginia,54005,Boone County,6816,2041,9012,4775,0.7563249001331558,0.22647581003106967,0.5298490901020861
West Virginia,54007,Braxton County,4120,1457,5664,2663,0.7274011299435028,0.2572387005649718,0.47016242937853103
West Virginia,54009,Brooke County,7545,2947,10656,4598,0.7080518018018018,0.2765578078078078,0.431493993993994
West Virginia,54011,Cabell County,21721,14994,37360,6727,0.5813972162740899,0.40133832976445394,0.18005888650963597
West Virginia,54013,Calhoun County,2364,568,2971,1796,0.7956916863009088,0.19118142039717267,0.6045102659037361
West Virginia,54015,Clay County,2679,641,3365,2038,0.7961367013372956,0.19049034175334323,0.6056463595839524
West Virginia,54017,Doddridge County,2619,435,3101,2184,0.8445662689455015,0.14027732989358271,0.7042889390519187
West Virginia,54019,Fayette County,11580,5063,16862,6517,0.6867512750563397,0.300260941762543,0.38649033329379673
West Virginia,54021,Gilmer County,2012,599,2662,1413,0.7558226897069872,0.22501878287002253,0.5308039068369647
West Virginia,54023,Grant County,4871,607,5509,4264,0.884189508077691,0.11018333635868578,0.7740061717190052
West Virginia,54025,Greenbrier County,10925,4655,15850,6270,0.6892744479495269,0.29369085173501575,0.3955835962145111
West Virginia,54027,Hampshire County,8033,1939,10086,6094,0.7964505254808646,0.19224667856434663,0.604203846916518
West Virginia,54029,Hancock County,9806,3790,13800,6016,0.7105797101449275,0.2746376811594203,0.4359420289855072
West Virginia,54031,Hardy County,4859,1381,6331,3478,0.7674932870004738,0.2181329963670826,0.5493602906333912
West Virginia,54033,Harrison County,20683,9215,30465,11468,0.6789102248481864,0.3024782537337929,0.3764319711143935
West Virginia,54035,Jackson County,10093,3207,13508,6886,0.7471868522357121,0.23741486526502814,0.509771986970684
West Virginia,54037,Jefferson County,15033,12127,27703,2906,0.5426488105981302,0.4377504241417897,0.10489838645634048
West Virginia,54039,Kanawha County,46398,34344,82244,12054,0.5641505763338359,0.41758669325421915,0.14656388307961676
West Virginia,54041,Lewis County,5782,1538,7457,4244,0.7753788386750704,0.20624916186133835,0.569129676813732
West Virginia,54043,Lincoln County,6012,1711,7830,4301,0.767816091954023,0.21851851851851853,0.5492975734355044
West Virginia,54045,Logan County,10534,2333,13026,8201,0.8086903116843237,0.17910333179794258,0.6295869798863811
West Virginia,54047,McDowell County,5148,1333,6527,3815,0.7887237628313161,0.20422858893825646,0.5844951738930596
West Virginia,54049,Marion County,16300,8901,25794,7399,0.6319299061797318,0.3450802512212142,0.28684965495851755
West Virginia,54051,Marshall County,10435,3455,14080,6980,0.7411221590909091,0.24538352272727273,0.49573863636363635
West Virginia,54053,Mason County,8491,2526,11203,5965,0.7579219851825404,0.22547531911095242,0.532446666071588
West Virginia,54055,Mercer County,19237,5556,25134,13681,0.765377576191613,0.2210551444258773,0.5443224317657357
West Virginia,54057,Mineral County,10040,2660,12872,7380,0.7799875699192045,0.20665009322560596,0.5733374766935986
West Virginia,54059,Mingo County,8544,1397,10022,7147,0.8525244462183197,0.13939333466373977,0.71313111155458
West Virginia,54061,Monongalia County,20803,20282,42072,521,0.4944618748811561,0.4820783418900932,0.012383532991062929
West Virginia,54063,Monroe County,5068,1345,6490,3723,0.7808936825885978,0.20724191063174113,0.5736517719568567
West Virginia,54065,Morgan County,6537,1998,8695,4539,0.751811385853939,0.2297872340425532,0.5220241518113858
West Virginia,54067,Nicholas County,8279,2226,10630,6053,0.7788334901222954,0.20940733772342426,0.5694261523988712
West Virginia,54069,Ohio County,12354,7223,19898,5131,0.6208664187355513,0.36300130666398633,0.25786511207156493
West Virginia,54071,Pendleton County,2782,820,3659,1962,0.7603170265099755,0.2241049467067505,0.5362120798032249
West Virginia,54073,Pleasants County,2742,699,3491,2043,0.7854482956173017,0.20022916069894015,0.5852191349183615
West Virginia,54075,Pocahontas County,2895,1047,4008,1848,0.7223053892215568,0.26122754491017963,0.4610778443113772
West Virginia,54077,Preston County,11190,3163,14572,8027,0.7679110623112819,0.21706011528959648,0.5508509470216855
West Virginia,54079,Putnam County,20034,7878,28501,12156,0.70292270446651,0.2764113539875794,0.4265113504789306
West Virginia,54081,Raleigh County,24673,7982,33106,16691,0.7452727602247327,0.24110433154111038,0.5041684286836223
West Virginia,54083,Randolph County,8673,3362,12200,5311,0.7109016393442623,0.27557377049180326,0.43532786885245905
West Virginia,54085,Ritchie County,3649,586,4283,3063,0.8519729161802475,0.1368199859911277,0.7151529301891197
West Virginia,54087,Roane County,4213,1455,5763,2758,0.7310428596217248,0.25247267048412286,0.4785701891376019
West Virginia,54089,Summers County,4074,1448,5585,2626,0.7294538943598926,0.25926589077887197,0.47018800358102064
West Virginia,54091,Taylor County,5477,1796,7383,3681,0.741839360693485,0.24326154679669512,0.4985778138967899
West Virginia,54093,Tucker County,2841,938,3844,1903,0.7390738813735692,0.24401664932362122,0.495057232049948
West Virginia,54095,Tyler County,3226,631,3922,2595,0.8225395206527282,0.16088730239673635,0.6616522182559919
West Virginia,54097,Upshur County,7771,2256,10221,5515,0.7602974268662558,0.2207220428529498,0.539575384013306
West Virginia,54099,Wayne County,12585,4088,16947,8497,0.7426093113825456,0.24122263527467988,0.5013866761078657
West Virginia,54101,Webster County,2759,610,3402,2149,0.8109935332157554,0.17930629041740154,0.6316872427983539
West Virginia,54103,Wetzel County,4993,1539,6667,3454,0.7489125543722814,0.23083845807709613,0.5180740962951853
West Virginia,54105,Wirt County,2134,466,2653,1668,0.8043724085940445,0.17565020731247644,0.6287222012815681
West Virginia,54107,Wood County,27202,10926,38762,16276,0.7017697745214385,0.28187400030958154,0.419895774211857
West Virginia,54109,Wyoming County,7353,1157,8592,6196,0.8557960893854749,0.13466014897579143,0.7211359404096835
Wisconsin,55001,Adams County,7362,4329,11818,3033,0.622948045354544,0.36630563547131495,0.256642409883229
Wisconsin,55003,Ashland County,3841,4801,8757,-960,0.438620532145712,0.5482471165924403,-0.10962658444672829
Wisconsin,55005,Barron County,15803,9194,25346,6609,0.6234908861358794,0.36273968279018387,0.26075120334569557
Wisconsin,55007,Bayfield County,4617,6147,10880,-1530,0.42435661764705884,0.5649816176470588,-0.14062499999999994
Wisconsin,55009,Brown County,75871,65511,144017,10360,0.5268197504461278,0.4548837984404619,0.07193595200566594
Wisconsin,55011,Buffalo County,4834,2860,7816,1974,0.618474923234391,0.36591606960081885,0.25255885363357217
Wisconsin,55013,Burnett County,6462,3569,10141,2893,0.6372152647667882,0.3519376787299083,0.28527758603687997
Wisconsin,55015,Calumet County,18156,12116,30774,6040,0.5899785533242348,0.3937089751088581,0.19626957821537666
Wisconsin,55017,Chippewa County,21317,13983,35938,7334,0.593160442985141,0.3890867605320274,0.20407368245311364
Wisconsin,55019,Clark County,10002,4524,14898,5478,0.6713652839307289,0.3036649214659686,0.36770036246476034
Wisconsin,55021,Columbia County,16927,16410,33869,517,0.4997785585638785,0.4845138622339012,0.01526469632997729
Wisconsin,55023,Crawford County,4620,3953,8695,667,0.5313398504887866,0.45462909718228867,0.07671075330649796
Wisconsin,55025,Dane County,78800,260185,344791,-181385,0.2285442485447706,0.7546165648175271,-0.5260723162727565
Wisconsin,55027,Dodge County,31355,16356,48436,14999,0.6473490791972912,0.3376827153357007,0.3096663638615905
Wisconsin,55029,Door County,9752,10044,20117,-292,0.4847641298404335,0.4992792165829895,-0.014515086742556027
Wisconsin,55031,Douglas County,10923,13218,24677,-2295,0.4426388945171617,0.5356404749361754,-0.09300158041901369
Wisconsin,55033,Dunn County,13173,9897,23524,3276,0.5599812956980106,0.42071926543104915,0.13926203026696143
Wisconsin,55035,Eau Claire County,25341,31620,58275,-6279,0.4348519948519948,0.5425997425997426,-0.10774774774774781
Wisconsin,55037,Florence County,2133,781,2940,1352,0.7255102040816327,0.26564625850340134,0.45986394557823135
Wisconsin,55039,Fond du Lac County,35754,20588,57251,15166,0.6245131089413285,0.3596094391364343,0.2649036698048942
Wisconsin,55041,Forest County,3285,1721,5053,1564,0.6501088462299623,0.3405897486641599,0.3095190975658024
Wisconsin,55043,Grant County,14142,10998,25608,3144,0.5522492970946579,0.42947516401124647,0.1227741330834114
Wisconsin,55045,Green County,10169,10851,21406,-682,0.4750537232551621,0.5069139493599926,-0.03186022610483047
Wisconsin,55047,Green Lake County,7168,3344,10671,3824,0.6717271108612126,0.3133726923437354,0.35835441851747724
Wisconsin,55049,Iowa County,5909,7828,13992,-1919,0.42231275014293884,0.5594625500285878,-0.13714979988564896
Wisconsin,55051,Iron County,2438,1533,4010,905,0.6079800498753117,0.38229426433915215,0.2256857855361596
Wisconsin,55053,Jackson County,5791,4256,10184,1535,0.5686370777690495,0.417910447761194,0.15072663000785547
Wisconsin,55055,Jefferson County,27208,19904,47979,7304,0.5670814314595969,0.41484816273786446,0.15223326872173243
Wisconsin,55057,Juneau County,8749,4746,13709,4003,0.6381938872273689,0.3461959296812313,0.2919979575461376
Wisconsin,55059,Kenosha County,44972,42193,88738,2779,0.5067952849962812,0.47547837454078296,0.03131691045549828
Wisconsin,55061,Kewaunee County,7927,3976,12095,3951,0.6553947912360479,0.3287308805291443,0.32666391070690365
Wisconsin,55063,La Crosse County,28684,37846,67884,-9162,0.4225443403452949,0.5575098697778563,-0.1349655294325614
Wisconsin,55065,Lafayette County,4821,3647,8555,1174,0.5635300993571011,0.4263004091174752,0.1372296902396259
Wisconsin,55067,Langlade County,7330,3704,11165,3626,0.6565158978952083,0.3317510076130766,0.3247648902821317
Wisconsin,55069,Lincoln County,10017,6261,16497,3756,0.6072013093289689,0.3795235497363157,0.22767775959265318
Wisconsin,55071,Manitowoc County,27218,16818,44829,10400,0.6071516206027349,0.37515893729505456,0.2319926833076803
Wisconsin,55073,Marathon County,44624,30808,76751,13816,0.5814126200310094,0.40140193613112535,0.180010683899884
Wisconsin,55075,Marinette County,15304,7366,22979,7938,0.6659993907480743,0.320553548892467,0.34544584185560734
Wisconsin,55077,Marquette County,5719,3239,9065,2480,0.6308880308880309,0.35730832873690016,0.27357970215113075
Wisconsin,55078,Menominee County,278,1303,1590,-1025,0.17484276729559747,0.819496855345912,-0.6446540880503145
Wisconsin,55079,Milwaukee County,134357,317270,458971,-182913,0.29273527085589285,0.6912637181869878,-0.398528447331095
Wisconsin,55081,Monroe County,13775,8433,22611,5342,0.6092167529078767,0.37296006368581663,0.23625668922206006
Wisconsin,55083,Oconto County,16226,6715,23215,9511,0.6989446478569891,0.28925263838035753,0.40969200947663154
Wisconsin,55085,Oneida County,13671,10105,24159,3566,0.56587607102943,0.418270623784097,0.14760544724533303
Wisconsin,55087,Outagamie County,58385,47667,108022,10718,0.5404917516802132,0.4412712225287441,0.09922052915146912
Wisconsin,55089,Ozaukee County,33912,26517,61486,7395,0.5515401880102787,0.4312689067429984,0.12027128126728032
Wisconsin,55091,Pepin County,2584,1489,4144,1095,0.6235521235521235,0.3593146718146718,0.2642374517374517
Wisconsin,55093,Pierce County,12815,9796,23317,3019,0.5495990050177981,0.4201226572886735,0.12947634772912464
Wisconsin,55095,Polk County,16611,9370,26371,7241,0.6298964771908536,0.35531455007394486,0.27458192711690876
Wisconsin,55097,Portage County,19299,20428,40603,-1129,0.47530970617934637,0.5031155333349753,-0.027805827155628904
Wisconsin,55099,Price County,5394,3032,8546,2362,0.6311724783524456,0.3547858647320384,0.27638661362040723
Wisconsin,55101,Racine County,54479,50159,106451,4320,0.5117753708278926,0.47119331899183664,0.040582051836055955
Wisconsin,55103,Richland County,4871,3995,9014,876,0.540381628577768,0.44319946749500777,0.09718216108276018
Wisconsin,55105,Rock County,37138,46658,85360,-9520,0.4350749765698219,0.5466026241799438,-0.11152764761012185
Wisconsin,55107,Rusk County,5257,2517,7886,2740,0.6666243976667512,0.3191732183616536,0.3474511793050976
Wisconsin,55109,St. Croix County,32199,23190,56707,9009,0.5678134974518138,0.4089442220537147,0.15886927539809903
Wisconsin,55111,Sauk County,17493,18108,36203,-615,0.4831920006629285,0.5001795431317847,-0.016987542468856198
Wisconsin,55113,Sawyer County,5909,4498,10510,1411,0.5622264509990486,0.4279733587059943,0.13425309229305427
Wisconsin,55115,Shawano County,15173,7131,22615,8042,0.6709263762989166,0.3153216891443732,0.3556046871545434
Wisconsin,55117,Sheboygan County,37609,27101,66011,10508,0.5697383769371771,0.4105527866567693,0.1591855902804078
Wisconsin,55119,Taylor County,7657,2693,10686,4964,0.7165450121654501,0.25201197828935057,0.4645330338760995
Wisconsin,55121,Trempealeau County,8833,6285,15380,2548,0.5743172951885566,0.4086475942782835,0.16566970091027305
Wisconsin,55123,Vernon County,8218,7457,15923,761,0.5161087734723356,0.46831627205928533,0.0477925014130503
Wisconsin,55125,Vilas County,9261,5903,15369,3358,0.6025766152644935,0.3840848461188106,0.21849176914568286
Wisconsin,55127,Walworth County,33851,22789,57600,11062,0.5876909722222222,0.3956423611111111,0.1920486111111111
Wisconsin,55129,Washburn County,6334,3867,10378,2467,0.6103295432645982,0.37261514742724994,0.23771439583734827
Wisconsin,55131,Washington County,60237,26650,88070,33587,0.6839672987396389,0.30260020438287727,0.38136709435676164
Wisconsin,55133,Waukesha County,159649,103906,267996,55743,0.5957141151360468,0.3877147420110748,0.20799937312497196
Wisconsin,55135,Waupaca County,18952,9703,29130,9249,0.6506007552351528,0.33309303123927225,0.31750772399588056
Wisconsin,55137,Waushara County,9016,4388,13568,4628,0.6645047169811321,0.32340801886792453,0.3410966981132076
Wisconsin,55139,Winnebago County,47796,44060,94032,3736,0.5082950484941297,0.4685638931427599,0.03973115535136973
Wisconsin,55141,Wood County,24308,16365,41298,7943,0.5885999322001065,0.39626616301031525,0.19233376918979128
Wyoming,56001,Albany County,8579,9092,18617,-513,0.46081538378901005,0.488370843852393,-0.02755546006338294
Wyoming,56003,Big Horn County,4806,788,5752,4018,0.8355354659248957,0.13699582753824757,0.6985396383866481
Wyoming,56005,Campbell County,16975,1935,19566,15040,0.867576408054789,0.09889604415823366,0.7686803638965554
Wyoming,56007,Carbon County,5014,1427,6664,3587,0.7524009603841537,0.2141356542617047,0.538265306122449
Wyoming,56009,Converse County,5917,861,6970,5056,0.8489239598278335,0.12352941176470589,0.7253945480631276
Wyoming,56011,Crook County,3651,378,4119,3273,0.8863801893663511,0.09176984705025491,0.7946103423160962
Wyoming,56013,Fremont County,12007,5519,18111,6488,0.6629672574678372,0.3047319308707415,0.3582353265970957
Wyoming,56015,Goshen County,4878,1203,6241,3675,0.7816055119371895,0.19275757090209902,0.5888479410350905
Wyoming,56017,Hot Springs County,1999,482,2577,1517,0.775708187815289,0.18703919285991463,0.5886689949553744
Wyoming,56019,Johnson County,3881,897,4914,2984,0.7897842897842898,0.18253968253968253,0.6072446072446073
Wyoming,56021,Laramie County,27891,15217,44982,12674,0.620048019207683,0.3382908719043173,0.28175714730336576
Wyoming,56023,Lincoln County,8643,1509,10468,7134,0.8256591517004204,0.1441536110049675,0.6815055406954529
Wyoming,56025,Natrona County,25271,8530,35202,16741,0.7178853474234419,0.24231577751264133,0.47556956991080057
Wyoming,56027,Niobrara County,1118,155,1308,963,0.8547400611620795,0.11850152905198777,0.7362385321100917
Wyoming,56029,Park County,12813,3410,16717,9403,0.7664652748698929,0.20398396841538555,0.5624813064545073
Wyoming,56031,Platte County,3898,890,4923,3008,0.7917936217753403,0.18078407475116798,0.6110095470241723
Wyoming,56033,Sheridan County,11843,4043,16428,7800,0.7209033357682006,0.24610421232042853,0.4747991234477721
Wyoming,56035,Sublette County,3957,882,4970,3075,0.7961770623742455,0.17746478873239438,0.6187122736418511
Wyoming,56037,Sweetwater County,12229,3823,16603,8406,0.7365536348852617,0.23025959164006504,0.5062940432451967
Wyoming,56039,Teton County,4341,9848,14677,-5507,0.2957688901001567,0.6709818082714452,-0.37521291817128843
Wyoming,56041,Uinta County,7496,1591,9402,5905,0.7972771750691342,0.16921931503935334,0.6280578600297808
Wyoming,56043,Washakie County,3245,651,4012,2594,0.8088235294117647,0.16226321036889332,0.6465603190428714
Wyoming,56045,Weston County,3107,360,3542,2747,0.8771880293619424,0.10163749294184077,0.7755505364201016
